Id,Label,timeset,indegree,outdegree,Degree,modularity_class
6.058,6.058,,14,0,14,1
M,M,,0,1663,1663,2
CMS.611,CMS.611,,9,0,9,0
E,E,,0,1645,1645,2
6.061,6.061,,2,0,2,4
21G.S05,21G.S05,,0,0,0,0
21G.S06,21G.S06,,0,0,0,0
21W.015,21W.015,,0,0,0,0
6.070,6.070,,0,0,0,0
1,1,,0,720,720,0
21G.S07,21G.S07,,0,0,0,0
6.08,6.08,,8,0,8,1
I,I,,0,1685,1685,2
7.931,7.931,,8,0,8,2
21G.S08,21G.S08,,0,0,0,0
6,6,,0,292,292,0
P,P,,0,1646,1646,2
21G.THT,21G.THT,,8,0,8,2
21G.S04,21G.S04,,0,0,0,0
21G.THU,21G.THU,,6,0,6,1
R,R,,0,1683,1683,2
L,L,,0,53,53,1
21G.UR,21G.UR,,0,0,0,0
21W.016,21W.016,,0,0,0,0
6.101,6.101,,4,0,4,0
11.801,11.801,,2,1,3,3
2,2,,0,512,512,0
21G.URG,21G.URG,,0,0,0,0
O,O,,0,1637,1637,2
6.111,6.111,,6,0,6,0
6.1151,6.1151,,7,0,7,0
18.968,18.968,,6,0,6,0
21G.503,21G.503,,14,0,14,0
.,.,,0,919,919,0
S,S,,0,1660,1660,2
21G.504,21G.504,,15,0,15,0
21W.021,21W.021,,0,0,0,0
21G.505,21G.505,,15,0,15,0
21G.501,21G.501,,0,0,0,0
4.592,4.592,,8,0,8,2
3,3,,0,291,291,0
21G.506,21G.506,,14,0,14,0
20.345,20.345,,16,0,16,4
21G.027,21G.027,,15,0,15,0
4,4,,0,319,319,0
6.129,6.129,,2,0,2,4
21G.502,21G.502,,0,0,0,0
IDS.435,IDS.435,,0,0,0,0
6.1311,6.1311,,6,0,6,0
21G.064,21G.064,,15,0,15,0
0,0,,0,669,669,0
21A.410,21A.410,,0,0,0,0
8.223,8.223,,2,0,2,4
21G.065,21G.065,,15,0,15,0
6.146,6.146,,0,0,0,0
EC.110,EC.110,,0,0,0,0
N,N,,0,1634,1634,2
18.994,18.994,,6,0,6,0
21G.094,21G.094,,15,0,15,0
5,5,,0,288,288,0
21G.063,21G.063,,15,0,15,0
21G.601,21G.601,,0,0,0,0
8,8,,0,261,261,0
21G.597,21G.597,,0,0,0,0
14.64,14.64,,13,0,13,0
21G.611,21G.611,,0,0,0,0
21W.031,21W.031,,0,0,0,0
21G.612,21G.612,,13,1,14,3
21G.613,21G.613,,2,1,3,3
14.662,14.662,,2,0,2,3
4.540,4.540,,0,0,0,0
21G.614,21G.614,,2,0,2,3
21G.077,21G.077,,14,0,14,0
21G.700,21G.700,,8,0,8,2
21G.701,21G.701,,0,0,0,0
4.489,4.489,,8,0,8,2
21G.702,21G.702,,14,0,14,0
21G.703,21G.703,,14,0,14,0
21G.704,21G.704,,15,0,15,0
GIR:CAL2,GIR:CAL2,,0,47,47,4
21H.134,21H.134,,0,0,0,0
6.141,6.141,,14,0,14,1
6.148,6.148,,8,0,8,2
6.147,6.147,,0,0,0,0
6.149,6.149,,0,0,0,0
:,:,,0,65,65,1
6.151,6.151,,0,0,0,0
CMS.992,CMS.992,,13,0,13,2
6.163,6.163,,13,0,13,1
6.161,6.161,,4,0,4,0
6.169,6.169,,4,0,4,0
17.266,17.266,,8,1,9,2
6.170,6.170,,2,0,2,1
4.491,4.491,,8,0,8,2
16.322,16.322,,4,0,4,1
6.172,6.172,,3,0,3,1
6.176,6.176,,0,0,0,0
6.175,6.175,,4,0,4,0
14.74,14.74,,2,0,2,3
7,7,,0,179,179,0
6.177,6.177,,0,0,0,0
G,G,,0,136,136,1
6.178,6.178,,0,0,0,0
6.179,6.179,,0,0,0,0
6.182,6.182,,0,0,0,0
16.343,16.343,,8,0,8,2
11.402,11.402,,0,0,0,0
14.15,14.15,,7,0,7,0
6.231,6.231,,5,0,5,1
21G.708,21G.708,,8,1,9,3
PERMISSION,PERMISSION,,0,90,90,3
21G.710,21G.710,,0,0,0,0
1.022,1.022,,12,0,12,1
4.URG,4.URG,,0,0,0,0
3.URG,3.URG,,0,0,0,0
21G.709,21G.709,,9,0,9,3
16.346,16.346,,5,0,5,0
4.492,4.492,,8,0,8,2
21G.711,21G.711,,15,0,15,0
1.032,1.032,,3,0,3,4
21G.712,21G.712,,15,0,15,0
21G.715,21G.715,,15,0,15,0
15.081J,15.081J,,0,1,1,12
A,A,,0,78,78,1
21G.713,21G.713,,15,0,15,0
C,C,,0,67,67,1
GIR:PHY1,GIR:PHY1,,0,39,39,4
21G.714,21G.714,,0,0,0,0
21G.731,21G.731,,0,2,2,3
21L.637,21L.637,,0,0,0,0
21L.636,21L.636,,0,0,0,0
21G.735,21G.735,,0,2,2,3
21L.638,21L.638,,0,0,0,0
9,9,,0,96,96,0
24.THG,24.THG,,8,0,8,2
T,T,,0,25,25,1
21G.732,21G.732,,0,0,0,0
11.406,11.406,,0,0,0,0
H,H,,0,41,41,1
1.035,1.035,,2,1,3,4
21G.736,21G.736,,0,0,0,0
21L.639,21L.639,,0,0,0,0
6.117,6.117,,0,0,0,0
5.00,5.00,,0,0,0,0
11.407,11.407,,8,0,8,2
6.241,6.241,,2,0,2,4
4.493,4.493,,8,0,8,2
6.245,6.245,,6,0,6,0
6.249,6.249,,8,0,8,2
14.473,14.473,,4,0,4,0
6.248,6.248,,11,0,11,2
15.677,15.677,,8,0,8,2
6.251,6.251,,5,0,5,0
6.252,6.252,,4,0,4,1
6.254,6.254,,6,0,6,0
6.261,6.261,,8,0,8,2
6.260,6.260,,8,0,8,2
6.256,6.256,,5,0,5,0
1.037,1.037,,0,0,0,0
6.262,6.262,,9,1,10,0
15.070,15.070,,12,0,12,0
5.04,5.04,,4,3,7,4
6.263,6.263,,8,0,8,0
4.494,4.494,,8,0,8,2
3.54,3.54,,5,0,5,0
21G.782,21G.782,,14,0,14,0
3.53,3.53,,4,0,4,0
21G.793,21G.793,,14,0,14,0
21G.801,21G.801,,0,0,0,0
21G.795,21G.795,,15,0,15,0
SCM.262,SCM.262,,13,0,13,2
4.42,4.42,,2,0,2,4
21G.802,21G.802,,14,0,14,0
21G.803,21G.803,,14,0,14,0
17.100,17.100,,8,0,8,2
21G.804,21G.804,,15,0,15,0
3.57,3.57,,8,0,8,2
21G.820,21G.820,,15,0,15,0
21G.821,21G.821,,15,0,15,0
14.999,14.999,,5,0,5,0
10.37,10.37,,2,3,5,4
21G.880,21G.880,,15,0,15,0
21G.901,21G.901,,0,0,0,0
CC.801,CC.801,,5,0,5,1
SCM.266,SCM.266,,7,0,7,0
6.267,6.267,,7,0,7,0
6.268,6.268,,2,0,2,1
3.692,3.692,,8,0,8,2
6.302,6.302,,6,1,7,0
6.301,6.301,,5,0,5,0
6.332,6.332,,8,0,8,2
STS.419,STS.419,,8,0,8,2
6.333,6.333,,8,0,8,2
11.304,11.304,,8,0,8,2
SCM.267,SCM.267,,7,0,7,0
18.336,18.336,,17,0,17,0
11.906,11.906,,0,0,0,0
6.334,6.334,,5,0,5,0
18.335,18.335,,6,0,6,0
3.691,3.691,,8,0,8,2
18.337,18.337,,6,0,6,0
STANDING,STANDING,,0,2,2,5
6.344,6.344,,2,0,2,1
6.341,6.341,,4,1,5,0
6.347,6.347,,8,0,8,2
6.345,6.345,,2,0,2,1
6.348,6.348,,8,0,8,2
SCM.269,SCM.269,,0,0,0,0
21G.902,21G.902,,14,0,14,0
6.374,6.374,,2,0,2,1
3.693,3.693,,0,0,0,0
21G.903,21G.903,,14,0,14,0
9.301,9.301,,8,0,8,2
21G.138,21G.138,,0,0,0,0
6.375,6.375,,4,0,4,0
21G.911,21G.911,,0,0,0,0
1.061,1.061,,5,0,5,0
3.694,3.694,,0,0,0,0
21G.036,21G.036,,14,0,14,0
IDS.012,IDS.012,,18,0,18,1
21G.046,21G.046,,14,0,14,0
3.695,3.695,,0,0,0,0
6.434,6.434,,22,0,22,0
21G.030,21G.030,,14,0,14,0
SCM.272,SCM.272,,0,0,0,0
GIR:PHY2,GIR:PHY2,,0,33,33,4
3.696,3.696,,0,0,0,0
6.437,6.437,,8,1,9,0
SCM.283,SCM.283,,0,0,0,0
21G.217,21G.217,,0,0,0,0
21G.219,21G.219,,0,0,0,0
21G.301,21G.301,,0,0,0,0
B,B,,0,47,47,0
21G.222,21G.222,,0,0,0,0
21G.223,21G.223,,0,0,0,0
21A.442,21A.442,,0,0,0,0
21G.226,21G.226,,0,0,0,0
5.063,5.063,,5,0,5,0
21G.227,21G.227,,0,0,0,0
3.91,3.91,,8,0,8,2
21G.233,21G.233,,0,0,0,0
21G.302,21G.302,,14,0,14,0
4.501,4.501,,4,0,4,0
10.960,10.960,,0,0,0,0
14.472,14.472,,4,0,4,0
3.932,3.932,,8,0,8,2
4.594,4.594,,8,0,8,2
6.440,6.440,,2,0,2,1
3.930,3.930,,0,0,0,0
6.441,6.441,,6,0,6,0
6.442,6.442,,7,0,7,0
6.450,6.450,,4,0,4,0
8.371,8.371,,6,0,6,0
6.452,6.452,,5,0,5,0
6.453,6.453,,2,0,2,1
6.454,6.454,,8,0,8,2
6.456,6.456,,4,0,4,1
11.S938,11.S938,,0,0,0,0
6.503,6.503,,17,0,17,0
STS.429,STS.429,,8,0,8,2
21W.735,21W.735,,0,0,0,0
21G.307,21G.307,,13,0,13,3
11.909,11.909,,0,0,0,0
CMS.S62,CMS.S62,,8,0,8,2
21G.308,21G.308,,15,2,17,0
21G.310,21G.310,,15,2,17,0
4.502,4.502,,12,0,12,0
21G.311,21G.311,,15,2,17,0
21G.312,21G.312,,15,2,17,0
21G.315,21G.315,,15,2,17,0
21G.325,21G.325,,0,2,2,3
21G.320,21G.320,,15,2,17,0
21G.026,21G.026,,15,0,15,0
21G.344,21G.344,,0,0,0,0
21G.321,21G.321,,0,2,2,3
21A.500,21A.500,,0,0,0,0
21G.322,21G.322,,0,2,2,3
ES.S70,ES.S70,,0,0,0,0
21G.341,21G.341,,15,2,17,0
21G.346,21G.346,,0,2,2,3
21G.347,21G.347,,0,2,2,3
7.S399,7.S399,,8,0,8,2
21G.404,21G.404,,15,0,15,0
1.252,1.252,,8,0,8,2
STS.441,STS.441,,0,0,0,0
21G.406,21G.406,,10,0,10,3
12.805,12.805,,5,0,5,0
21W.745,21W.745,,8,0,8,2
21G.407,21G.407,,10,0,10,3
21G.412,21G.412,,14,2,16,0
12.961,12.961,,8,0,8,2
SCM.260,SCM.260,,8,0,8,2
6.630,6.630,,5,0,5,0
6.631,6.631,,7,0,7,0
6.632,6.632,,7,0,7,0
SCM.261,SCM.261,,8,0,8,2
6.634,6.634,,7,0,7,0
6.641,6.641,,5,0,5,0
8.292,8.292,,14,0,14,0
6.645,6.645,,8,0,8,2
6.644,6.644,,8,0,8,2
6.642,6.642,,12,0,12,0
6.685,6.685,,13,0,13,0
16.423,16.423,,13,0,13,0
IDS.064,IDS.064,,16,0,16,0
6.701,6.701,,4,0,4,0
7.S931,7.S931,,8,0,8,2
21G.414,21G.414,,6,2,8,0
21G.415,21G.415,,6,2,8,0
21G.416,21G.416,,6,2,8,0
21M.340,21M.340,,14,0,14,0
21G.417,21G.417,,14,2,16,0
21G.058,21G.058,,14,0,14,0
21G.420,21G.420,,14,2,16,0
21G.011,21G.011,,0,0,0,0
21G.019,21G.019,,0,0,0,0
21L.522,21L.522,,0,0,0,0
11.960,11.960,,0,0,0,0
18.385,18.385,,6,0,6,0
6.728,6.728,,2,2,4,4
6.731,6.731,,2,0,2,4
6.735,6.735,,8,0,8,2
Y,Y,,0,11,11,1
6.736,6.736,,8,0,8,2
6.732,6.732,,8,0,8,0
6.774,6.774,,5,0,5,0
6.776,6.776,,5,0,5,0
GIR:CAL1,GIR:CAL1,,0,16,16,4
17.509,17.509,,0,0,0,0
6.801,6.801,,12,0,12,0
6.802,6.802,,12,0,12,4
21G.040,21G.040,,0,0,0,0
21G.043,21G.043,,0,0,0,0
2.05,2.05,,4,1,5,0
11.524,11.524,,13,0,13,0
21G.049,21G.049,,0,0,0,0
21G.052,21G.052,,0,0,0,0
21G.053,21G.053,,0,0,0,0
15.015,15.015,,8,0,8,2
21H.241,21H.241,,0,0,0,0
21G.055,21G.055,,0,0,0,0
21G.057,21G.057,,0,0,0,0
15.013,15.013,,4,0,4,0
12.512,12.512,,4,0,4,0
21G.059,21G.059,,0,0,0,0
21M.341,21M.341,,15,0,15,0
21G.068,21G.068,,0,0,0,0
21G.070,21G.070,,0,0,0,0
6.805,6.805,,8,0,8,2
6.803,6.803,,13,0,13,0
9.66,9.66,,18,0,18,0
15.014,15.014,,5,0,5,0
21H.172,21H.172,,0,0,0,0
21H.244,21H.244,,0,0,0,0
6.806,6.806,,12,0,12,0
6.807,6.807,,13,0,13,0
21G.101,21G.101,,0,0,0,0
21M.385,21M.385,,10,0,10,4
21G.102,21G.102,,13,0,13,0
6.813,6.813,,13,0,13,0
6.814,6.814,,11,0,11,1
21G.104,21G.104,,14,0,14,0
6.815,6.815,,2,0,2,1
6.816,6.816,,3,0,3,0
21G.106,21G.106,,14,0,14,0
8.02,8.02,,2,0,2,4
6.819,6.819,,3,0,3,1
6.822,6.822,,2,0,2,1
21G.108,21G.108,,14,0,14,0
Q,Q,,0,7,7,0
12.981,12.981,,8,0,8,2
6.824,6.824,,2,0,2,1
11.963,11.963,,8,0,8,2
21G.045,21G.045,,0,0,0,0
6.431B,6.431B,,0,5,5,1
4.522,4.522,,13,0,13,0
GIR:BIOL,GIR:BIOL,,0,21,21,4
1.204,1.204,,10,0,10,1
6.828,6.828,,2,0,2,1
21G.120,21G.120,,15,0,15,0
D,D,,0,10,10,2
STS.URG,STS.URG,,0,0,0,0
6.832,6.832,,14,0,14,0
3.98,3.98,,0,0,0,0
21H.171,21H.171,,0,0,0,0
11.964,11.964,,8,0,8,2
16.412,16.412,,5,0,5,1
15.0251,15.0251,,5,0,5,0
21H.201,21H.201,,0,0,0,0
6.835,6.835,,14,0,14,0
STS.002,STS.002,,0,0,0,0
21H.211,21H.211,,0,0,0,0
6.837,6.837,,10,0,10,1
6.839,6.839,,15,0,15,0
6.838,6.838,,5,0,5,0
21H.227,21H.227,,0,0,0,0
21H.228,21H.228,,0,0,0,0
21H.229,21H.229,,0,0,0,0
21H.237,21H.237,,0,0,0,0
21H.239,21H.239,,0,0,0,0
21H.240,21H.240,,0,0,0,0
3.S02,3.S02,,8,0,8,2
21H.262,21H.262,,0,0,0,0
WGS.220,WGS.220,,0,0,0,0
21H.273,21H.273,,0,0,0,0
11.245,11.245,,8,0,8,2
6.842,6.842,,2,0,2,1
18.405,18.405,,5,0,5,0
11.985,11.985,,0,0,0,0
6.845,6.845,,3,0,3,1
11.483,11.483,,8,0,8,2
6.846,6.846,,12,0,12,0
6.849,6.849,,12,0,12,0
6.851,6.851,,4,0,4,0
6.850,6.850,,4,0,4,0
8.01,8.01,,0,0,0,0
6.852,6.852,,4,0,4,0
6.853,6.853,,4,0,4,0
3.998,3.998,,0,0,0,0
6.854,6.854,,4,0,4,1
6.856,6.856,,10,0,10,0
14.581,14.581,,4,0,4,0
6.857,6.857,,2,0,2,1
6.858,6.858,,2,0,2,1
9.523,9.523,,8,0,8,2
HST.165,HST.165,,8,0,8,2
9.520,9.520,,16,0,16,0
8.321,8.321,,4,2,6,0
21H.333,21H.333,,0,0,0,0
6.863,6.863,,5,0,5,0
21H.336,21H.336,,0,0,0,0
11.488,11.488,,8,0,8,2
21H.350,21H.350,,0,0,0,0
6.868,6.868,,0,0,0,0
21H.354,21H.354,,0,0,0,0
11.S195,11.S195,,0,0,0,0
21H.357,21H.357,,0,0,0,0
21H.358,21H.358,,0,0,0,0
3.S04,3.S04,,8,0,8,2
21H.365,21H.365,,0,0,0,0
21H.381,21H.381,,0,0,0,0
6.870,6.870,,14,0,14,0
21H.382,21H.382,,0,0,0,0
21H.383,21H.383,,0,0,0,0
8.324,8.324,,2,2,4,4
21H.392,21H.392,,0,0,0,0
6.872,6.872,,13,0,13,0
21H.391,21H.391,,0,0,0,0
8.323,8.323,,5,2,7,4
3.S06,3.S06,,8,0,8,2
21H.390,21H.390,,0,0,0,0
16.475,16.475,,0,0,0,0
6.876,6.876,,5,0,5,0
6.875,6.875,,5,0,5,0
21H.902,21H.902,,2,0,2,3
6.881,6.881,,8,0,8,2
21H.981,21H.981,,0,0,0,0
6.882,6.882,,8,0,8,2
6.883,6.883,,8,0,8,2
6.884,6.884,,8,0,8,2
21H.983,21H.983,,0,0,0,0
6.885,6.885,,8,0,8,2
8.012,8.012,,0,0,0,0
21H.993,21H.993,,8,0,8,2
21H.992,21H.992,,8,0,8,2
21H.999,21H.999,,0,0,0,0
21H.S01,21H.S01,,8,0,8,2
21H.S02,21H.S02,,8,0,8,2
21H.S03,21H.S03,,0,0,0,0
21H.THT,21H.THT,,0,0,0,0
21H.THU,21H.THU,,5,0,5,1
V,V,,0,7,7,2
21H.001,21H.001,,0,0,0,0
21H.007,21H.007,,0,0,0,0
11.S196,11.S196,,0,0,0,0
21H.009,21H.009,,0,0,0,0
21H.101,21H.101,,0,0,0,0
10.972,10.972,,8,0,8,2
16.50,16.50,,3,0,3,4
WGS.110,WGS.110,,0,0,0,0
21H.130,21H.130,,0,0,0,0
21H.132,21H.132,,0,0,0,0
21H.133,21H.133,,0,0,0,0
8.334,8.334,,3,0,3,0
6.886,6.886,,8,0,8,2
6.887,6.887,,8,0,8,2
6.888,6.888,,8,0,8,2
6.889,6.889,,8,0,8,2
6.890,6.890,,8,0,8,2
6.891,6.891,,8,0,8,2
6.892,6.892,,8,0,8,2
6.893,6.893,,8,0,8,2
6.894,6.894,,8,0,8,2
6.895,6.895,,8,0,8,2
6.896,6.896,,8,0,8,2
21G.738,21G.738,,0,1,1,3
15.359,15.359,,0,0,0,0
16.511,16.511,,13,0,13,0
6.903,6.903,,0,0,0,0
21G.739,21G.739,,0,2,2,3
6.910,6.910,,8,0,8,2
8.361,8.361,,2,0,2,4
6.905,6.905,,13,0,13,0
6.906,6.906,,0,0,0,0
6.913,6.913,,13,0,13,0
6.912,6.912,,12,0,12,0
16.512,16.512,,13,0,13,0
6.914,6.914,,12,0,12,0
6.915,6.915,,0,0,0,0
6.920,6.920,,0,0,0,0
6.921,6.921,,0,0,0,0
6.928,6.928,,0,0,0,0
6.922,6.922,,5,0,5,0
21H.151,21H.151,,0,0,0,0
21H.152,21H.152,,0,0,0,0
21H.154,21H.154,,0,0,0,0
21H.155,21H.155,,0,0,0,0
21H.157,21H.157,,0,0,0,0
21H.160,21H.160,,0,0,0,0
21H.161,21H.161,,0,0,0,0
15.9001,15.9001,,0,0,0,0
15.680,15.680,,0,0,0,0
21H.165,21H.165,,0,0,0,0
21L.706,21L.706,,0,0,0,0
21L.715,21L.715,,0,0,0,0
21L.704,21L.704,,0,0,0,0
21L.705,21L.705,,0,0,0,0
21L.901,21L.901,,8,0,8,2
8.392,8.392,,8,0,8,2
STS.048,STS.048,,0,0,0,0
21L.709,21L.709,,0,0,0,0
21L.900,21L.900,,8,0,8,2
IDS.330,IDS.330,,11,0,11,2
21L.S88,21L.S88,,8,0,8,2
21L.S89,21L.S89,,8,0,8,2
CMS.339,CMS.339,,8,0,8,2
21L.S90,21L.S90,,8,0,8,2
21L.000,21L.000,,0,0,0,0
21L.001,21L.001,,0,0,0,0
21L.002,21L.002,,0,0,0,0
21L.003,21L.003,,0,0,0,0
16.55,16.55,,12,0,12,0
21L.004,21L.004,,0,0,0,0
6.246,6.246,,8,0,8,2
16.622,16.622,,4,0,4,0
6.247,6.247,,8,0,8,2
1.075,1.075,,13,0,13,0
21L.012,21L.012,,0,0,0,0
12.008,12.008,,3,0,3,3
6.960,6.960,,8,0,8,2
21L.015,21L.015,,0,0,0,0
15.681,15.681,,0,0,0,0
16.621,16.621,,5,0,5,0
IDS.333,IDS.333,,0,0,0,0
21L.017,21L.017,,0,0,0,0
6.952,6.952,,5,0,5,0
6.961,6.961,,8,0,8,2
6.S076,6.S076,,8,0,8,2
21L.019,21L.019,,0,0,0,0
6.962,6.962,,0,0,0,0
6.981,6.981,,0,0,0,0
IDS.045,IDS.045,,0,0,0,0
21L.021,21L.021,,0,0,0,0
6.991,6.991,,0,0,0,0
6.999,6.999,,0,0,0,0
12.571,12.571,,8,0,8,2
21L.S91,21L.S91,,8,0,8,2
10.391,10.391,,0,1,1,11
21L.S93,21L.S93,,8,0,8,2
6.S062,6.S062,,0,0,0,0
20.320,20.320,,5,2,7,4
21L.S94,21L.S94,,8,0,8,2
21L.S95,21L.S95,,8,0,8,2
21L.S96,21L.S96,,0,0,0,0
15.390,15.390,,0,1,1,11
21L.THU,21L.THU,,6,0,6,1
15.371,15.371,,0,1,1,11
21L.024,21L.024,,0,0,0,0
21L.338,21L.338,,8,0,8,2
21L.430,21L.430,,0,0,0,0
21L.433,21L.433,,13,0,13,0
6.S078,6.S078,,8,0,8,2
6.S079,6.S079,,8,0,8,2
6.S080,6.S080,,8,0,8,2
6.S081,6.S081,,8,0,8,2
6.S082,6.S082,,8,0,8,2
6.S083,6.S083,,8,0,8,2
6.S084,6.S084,,8,0,8,2
6.S085,6.S085,,8,0,8,2
6.S086,6.S086,,8,0,8,2
12.S492,12.S492,,8,0,8,2
6.S087,6.S087,,8,0,8,2
6.S088,6.S088,,8,0,8,2
6.S089,6.S089,,8,0,8,2
6.S090,6.S090,,8,0,8,2
6.S091,6.S091,,8,0,8,2
6.S092,6.S092,,8,0,8,2
6.S093,6.S093,,8,0,8,2
6.S094,6.S094,,8,0,8,2
6.S095,6.S095,,8,0,8,2
6.S096,6.S096,,8,0,8,2
6.S097,6.S097,,8,0,8,2
6.S098,6.S098,,8,0,8,2
6.S099,6.S099,,8,0,8,2
6.S183,6.S183,,8,0,8,2
6.S184,6.S184,,8,0,8,2
6.S185,6.S185,,8,0,8,2
6.S186,6.S186,,8,0,8,2
6.S187,6.S187,,8,0,8,2
6.S188,6.S188,,8,0,8,2
6.S189,6.S189,,8,0,8,2
6.S190,6.S190,,8,0,8,2
6.S191,6.S191,,8,0,8,2
GIR:CHEM,GIR:CHEM,,0,22,22,4
6.S192,6.S192,,8,0,8,2
6.S193,6.S193,,8,0,8,2
6.S194,6.S194,,8,0,8,2
6.S195,6.S195,,8,0,8,2
6.S196,6.S196,,8,0,8,2
21L.458,21L.458,,0,0,0,0
21L.451,21L.451,,0,0,0,0
8.851,8.851,,5,0,5,0
21L.455,21L.455,,0,0,0,0
21L.460,21L.460,,0,0,0,0
WGS.245,WGS.245,,0,0,0,0
21L.471,21L.471,,0,0,0,0
21L.473,21L.473,,0,0,0,0
11.495,11.495,,8,0,8,2
21L.475,21L.475,,0,0,0,0
21L.501,21L.501,,8,0,8,2
21L.485,21L.485,,0,0,0,0
21W.765,21W.765,,0,0,0,0
21L.486,21L.486,,0,0,0,0
21L.487,21L.487,,0,0,0,0
21L.488,21L.488,,0,0,0,0
21L.504,21L.504,,8,0,8,2
21L.580,21L.580,,0,0,0,0
21L.590,21L.590,,8,0,8,2
21L.512,21L.512,,0,0,0,0
12.484,12.484,,8,0,8,2
21L.607,21L.607,,0,0,0,0
21L.608,21L.608,,15,0,15,0
21L.611,21L.611,,0,0,0,0
6.S197,6.S197,,8,0,8,2
6.S899,6.S899,,8,0,8,2
6.S911,6.S911,,8,0,8,2
6.S976,6.S976,,8,0,8,2
6.S965,6.S965,,0,0,0,0
11.521,11.521,,10,0,10,3
21M.011,21M.011,,0,0,0,0
6.S978,6.S978,,8,0,8,2
21M.051,21M.051,,0,1,1,4
6.UAP,6.UAP,,5,0,5,1
11.520,11.520,,13,0,13,0
6.UR,6.UR,,0,1,1,3
11.522,11.522,,12,0,12,0
7.03,7.03,,7,5,12,4
7.014,7.014,,0,0,0,0
MAS.945,MAS.945,,8,0,8,2
21M.250,21M.250,,13,0,13,0
7.015,7.015,,0,0,0,0
7.02,7.02,,7,3,10,1
7.016,7.016,,0,0,0,0
21M.260,21M.260,,13,0,13,0
21M.271,21M.271,,0,0,0,0
7.06,7.06,,2,6,8,4
21M.273,21M.273,,0,0,0,0
21M.283,21M.283,,0,0,0,0
21M.284,21M.284,,0,0,0,0
7.09,7.09,,2,0,2,4
21M.291,21M.291,,0,0,0,0
7.102,7.102,,0,0,0,0
7.11,7.11,,0,0,0,0
7.18,7.18,,0,0,0,0
21M.292,21M.292,,0,0,0,0
21M.294,21M.294,,0,0,0,0
21M.295,21M.295,,0,0,0,0
7.21,7.21,,2,0,2,4
7.20,7.20,,4,0,4,0
21M.301,21M.301,,0,1,1,4
11.355,11.355,,14,0,14,0
21M.299,21M.299,,13,0,13,0
7.23,7.23,,4,0,4,0
7.22,7.22,,4,0,4,0
7.26,7.26,,4,0,4,0
7.27,7.27,,4,0,4,0
11.533,11.533,,5,0,5,0
21M.304,21M.304,,6,0,6,0
7.28,7.28,,2,1,3,4
21M.310,21M.310,,14,0,14,0
21M.361,21M.361,,0,0,0,0
21M.359,21M.359,,13,0,13,0
21M.387,21M.387,,3,0,3,4
8.512,8.512,,4,0,4,0
10.702,10.702,,0,2,2,4
7.340,7.340,,6,0,6,0
4.609,4.609,,8,0,8,2
7.344,7.344,,6,0,6,0
21M.442,21M.442,,0,0,0,0
4.105,4.105,,8,0,8,2
21M.450,21M.450,,8,0,8,2
21M.451,21M.451,,0,0,0,0
3.081,3.081,,14,0,14,0
21M.480,21M.480,,0,0,0,0
7.393,7.393,,0,0,0,0
21M.500,21M.500,,8,0,8,2
7.421,7.421,,8,0,8,2
1.582,1.582,,8,0,8,2
21M.531,21M.531,,8,0,8,2
16.681,16.681,,0,0,0,0
MAS.825,MAS.825,,8,0,8,2
7.439,7.439,,8,0,8,2
7.440,7.440,,19,0,19,1
21M.600,21M.600,,0,1,1,3
21M.601,21M.601,,0,0,0,0
7.470,7.470,,8,0,8,2
7.491,7.491,,8,0,8,2
16.683,16.683,,0,0,0,0
4.119,4.119,,4,0,4,0
11.901,11.901,,8,0,8,2
16.202,16.202,,0,0,0,0
16.687,16.687,,0,0,0,0
21M.423,21M.423,,13,0,13,0
4.123,4.123,,0,0,0,0
4.141,4.141,,8,0,8,2
STS.467,STS.467,,8,0,8,2
9.18,9.18,,15,0,15,0
21M.605,21M.605,,0,0,0,0
21M.606,21M.606,,0,0,0,0
18.979,18.979,,8,0,8,2
21M.611,21M.611,,0,0,0,0
7.498,7.498,,8,0,8,2
21M.690,21M.690,,0,1,1,3
7.51,7.51,,8,2,10,3
7.52,7.52,,8,2,10,3
11.905,11.905,,8,0,8,2
2.034,2.034,,8,0,8,2
21M.704,21M.704,,13,0,13,0
15.136,15.136,,8,0,8,2
15.480,15.480,,2,0,2,3
21M.711,21M.711,,0,0,0,0
21M.715,21M.715,,8,0,8,2
21M.732,21M.732,,8,0,8,2
7.55,7.55,,8,0,8,2
20.486,20.486,,0,0,0,0
7.57,7.57,,8,0,8,2
21M.734,21M.734,,8,0,8,2
7.61,7.61,,8,0,8,2
4.152,4.152,,4,0,4,0
21M.733,21M.733,,14,0,14,0
11.907,11.907,,8,0,8,2
21M.735,21M.735,,13,0,13,0
8.624,8.624,,6,0,6,0
7.60,7.60,,12,0,12,0
5.05,5.05,,2,0,2,4
21M.785,21M.785,,17,0,17,0
4.154,4.154,,5,0,5,0
16.715,16.715,,7,0,7,4
8.642,8.642,,5,0,5,0
4.181,4.181,,8,0,8,2
7.64,7.64,,8,0,8,2
21L.701,21L.701,,0,0,0,0
9.322,9.322,,8,0,8,2
STS.418,STS.418,,0,0,0,0
1.085,1.085,,5,0,5,0
9.015,9.015,,0,0,0,0
8.701,8.701,,5,1,6,0
9.013,9.013,,8,0,8,2
7.70,7.70,,8,0,8,2
CMS.994,CMS.994,,8,0,8,2
4.180,4.180,,13,0,13,0
7.72,7.72,,8,0,8,2
21H.322,21H.322,,0,0,0,0
4.183,4.183,,8,0,8,2
7.76,7.76,,8,0,8,2
CMS.995,CMS.995,,8,0,8,2
7.77,7.77,,13,0,13,0
21M.426,21M.426,,0,0,0,0
1.721,1.721,,3,0,3,4
8.914,8.914,,8,0,8,2
15.276,15.276,,0,0,0,0
7.82,7.82,,8,0,8,2
CSB.100,CSB.100,,8,0,8,2
1.723,1.723,,8,0,8,2
4.189,4.189,,8,0,8,2
21G.S01,21G.S01,,0,0,0,0
16.002,16.002,,5,7,12,4
8.712,8.712,,12,0,12,0
16.004,16.004,,6,7,13,4
8.782,8.782,,4,0,4,0
8.781,8.781,,4,0,4,0
16.09,16.09,,8,5,13,1
CMS.S63,CMS.S63,,0,0,0,0
16.07,16.07,,4,0,4,4
16.101,16.101,,0,0,0,0
CMS.S96,CMS.S96,,8,0,8,2
4.194,4.194,,8,0,8,2
1.74,1.74,,0,0,0,0
16.120,16.120,,11,0,11,0
16.110,16.110,,12,0,12,0
CMS.S97,CMS.S97,,8,0,8,2
1.76,1.76,,12,0,12,0
21G.074,21G.074,,0,0,0,0
8.790,8.790,,7,0,7,0
9.71,9.71,,15,0,15,0
5.061,5.061,,4,0,4,0
8.812,8.812,,5,0,5,0
8.811,8.811,,5,0,5,0
CMS.S99,CMS.S99,,8,0,8,2
24.943,24.943,,8,0,8,2
J,J,,0,17,17,0
8.821,8.821,,5,0,5,0
5.52,5.52,,8,0,8,2
IDS.060,IDS.060,,0,0,0,0
8.831,8.831,,8,0,8,2
10.989,10.989,,8,0,8,2
MAS.S66,MAS.S66,,8,0,8,2
16.121,16.121,,14,0,14,0
16.122,16.122,,14,0,14,0
12.485,12.485,,5,0,5,0
18.089,18.089,,8,0,8,2
16.13,16.13,,12,0,12,0
IDS.061,IDS.061,,12,0,12,0
16.20,16.20,,4,0,4,0
16.201,16.201,,0,0,0,0
CMS.THU,CMS.THU,,6,0,6,1
CMS.THT,CMS.THT,,11,0,11,2
16.30,16.30,,6,1,7,0
8.871,8.871,,4,0,4,0
CMS.UR,CMS.UR,,0,0,0,0
8.872,8.872,,4,0,4,0
10.990,10.990,,0,0,0,0
1.83,1.83,,2,0,2,4
8.901,8.901,,8,0,8,2
16.355,16.355,,8,0,8,2
16.35,16.35,,5,0,5,0
1.841,1.841,,4,0,4,0
16.36,16.36,,4,0,4,1
1.84,1.84,,4,0,4,0
WGS.111,WGS.111,,0,0,0,0
21G.904,21G.904,,15,0,15,0
16.393,16.393,,12,0,12,0
18.098,18.098,,8,0,8,2
16.410,16.410,,5,0,5,0
16.420,16.420,,5,0,5,0
16.821,16.821,,8,0,8,2
HST.514,HST.514,,8,0,8,2
24.946,24.946,,8,0,8,2
16.440,16.440,,15,0,15,0
15.4331,15.4331,,5,0,5,0
18.095,18.095,,8,0,8,1
21M.013,21M.013,,0,0,0,0
MAS.940,MAS.940,,8,0,8,2
6.436,6.436,,8,1,9,1
24.947,24.947,,0,0,0,0
16.459,16.459,,0,0,0,0
21G.038,21G.038,,14,0,14,0
16.470,16.470,,15,0,15,0
11.S198,11.S198,,0,0,0,0
21G.044,21G.044,,14,0,14,0
6.621,6.621,,8,0,8,0
16.522,16.522,,13,0,13,0
16.863,16.863,,8,0,8,2
16.885,16.885,,8,0,8,2
FIRST-YEAR,FIRST-YEAR,,0,2,2,5
4.216,4.216,,8,0,8,2
21G.075,21G.075,,14,0,14,0
6.438,6.438,,4,0,4,1
16.886,16.886,,8,0,8,2
11.S939,11.S939,,0,0,0,0
18.099,18.099,,8,0,8,2
4.S44,4.S44,,8,0,8,2
11.S940,11.S940,,8,0,8,2
21G.199,21G.199,,2,0,2,3
15.218,15.218,,0,0,0,0
5.069,5.069,,2,0,2,4
21G.218,21G.218,,0,0,0,0
11.S942,11.S942,,8,0,8,2
16.64,16.64,,5,0,5,0
IDS.338,IDS.338,,13,0,13,0
11.S943,11.S943,,8,0,8,2
16.66,16.66,,0,1,1,14
16.682,16.682,,0,0,0,0
16.691,16.691,,0,0,0,0
16.72,16.72,,8,0,8,2
15.093,15.093,,0,1,1,1
11.328,11.328,,0,1,1,3
IDS.449,IDS.449,,12,0,12,2
16.90,16.90,,7,0,7,1
18.100B,18.100B,,8,11,19,1
16.767,16.767,,8,0,8,2
11.S951,11.S951,,8,0,8,2
16.82,16.82,,8,0,8,2
8.952,8.952,,2,0,2,4
16.842,16.842,,8,0,8,2
16.851,16.851,,8,0,8,2
CMS.621,CMS.621,,0,0,0,0
IDS.336,IDS.336,,8,0,8,2
8.972,8.972,,8,0,8,2
STS.471,STS.471,,8,0,8,2
21G.228,21G.228,,0,0,0,0
16.89,16.89,,13,0,13,0
STS.463,STS.463,,0,0,0,0
3.072,3.072,,6,0,6,0
9.S51,9.S51,,0,0,0,0
9.941,9.941,,8,0,8,2
11.302,11.302,,8,0,8,2
8.981,8.981,,8,0,8,2
16.971,16.971,,0,0,0,0
16.940,16.940,,10,0,10,1
16.980,16.980,,8,0,8,2
1.205,1.205,,12,0,12,0
16.981,16.981,,8,0,8,2
CMS.631,CMS.631,,0,0,0,0
1.899,1.899,,8,0,8,2
5.08,5.08,,3,0,3,4
16.999,16.999,,0,0,0,0
1.968,1.968,,8,0,8,2
8.995,8.995,,0,0,0,0
4.552,4.552,,8,0,8,2
8.S04,8.S04,,3,0,3,4
15.132,15.132,,0,0,0,0
21G.303,21G.303,,14,0,14,0
8.S421,8.S421,,8,0,8,2
1.999,1.999,,0,0,0,0
4.541,4.541,,4,0,4,0
1.S82,1.S82,,8,0,8,2
21G.304,21G.304,,14,0,14,0
15.280,15.280,,8,0,8,2
8.THG,8.THG,,8,0,8,2
16.S685,16.S685,,8,0,8,2
1.S978,1.S978,,8,0,8,2
16.S688,16.S688,,0,0,0,0
CMS.801,CMS.801,,8,0,8,2
16.S890,16.S890,,8,0,8,2
16.S893,16.S893,,0,0,0,0
16.S896,16.S896,,8,0,8,2
16.S199,16.S199,,8,0,8,2
8.S851,8.S851,,2,0,2,4
16.S898,16.S898,,8,0,8,2
16.S899,16.S899,,8,0,8,2
16.S948,16.S948,,8,0,8,2
9.011,9.011,,8,0,8,2
16.S949,16.S949,,8,0,8,2
1.S981,1.S981,,8,0,8,2
16.S983,16.S983,,0,0,0,0
17.436,17.436,,0,0,0,0
16.THG,16.THG,,0,0,0,0
1.S982,1.S982,,8,0,8,2
24.04,24.04,,0,0,0,0
8.UR,8.UR,,0,0,0,0
21H.181,21H.181,,0,0,0,0
17.03,17.03,,0,0,0,0
4.S51,4.S51,,0,0,0,0
9.00,9.00,,0,6,6,3
11.S197,11.S197,,0,0,0,0
4.130,4.130,,8,0,8,2
1.THG,1.THG,,8,0,8,2
7.32,7.32,,10,1,11,1
14.444,14.444,,5,0,5,0
5.112,5.112,,0,0,0,0
16.S399,16.S399,,8,0,8,2
4.553,4.553,,8,0,8,2
CC.111,CC.111,,0,0,0,0
9.S912,9.S912,,8,0,8,2
CC.117,CC.117,,0,0,0,0
17.115,17.115,,0,0,0,0
CMS.405,CMS.405,,8,0,8,0
17.150,17.150,,8,0,8,2
17.154,17.154,,8,0,8,2
16.S499,16.S499,,8,0,8,2
17.156,17.156,,8,0,8,2
17.172,17.172,,8,0,8,2
17.178,17.178,,8,0,8,2
U,U,,0,4,4,1
17.181,17.181,,0,0,0,0
2.001,2.001,,3,11,14,4
WGS.101,WGS.101,,0,0,0,0
MAS.863,MAS.863,,8,0,8,2
17.195,17.195,,8,0,8,2
17.198,17.198,,8,0,8,2
17.20,17.20,,0,0,0,0
17.200,17.200,,8,0,8,2
17.210,17.210,,5,0,5,0
17.245,17.245,,0,0,0,0
15.437,15.437,,5,0,5,0
14.451,14.451,,2,4,6,3
17.270,17.270,,8,0,8,2
16.422,16.422,,8,0,8,2
11.S199,11.S199,,0,0,0,0
17.309,17.309,,0,0,0,0
15.S26,15.S26,,8,0,8,2
17.317,17.317,,0,0,0,0
21L.005,21L.005,,0,0,0,0
24.960,24.960,,2,0,2,9
8.03,8.03,,2,13,15,4
SCM.THG,SCM.THG,,0,0,0,0
5.310,5.310,,4,4,8,4
STS.081,STS.081,,0,0,0,0
21A.331,21A.331,,0,0,0,0
17.40,17.40,,0,0,0,0
17.401,17.401,,0,0,0,0
17.407,17.407,,8,0,8,2
18.101,18.101,,7,1,8,1
17.408,17.408,,8,0,8,2
17.41,17.41,,0,0,0,0
17.411,17.411,,8,0,8,2
15.394,15.394,,0,0,0,0
17.418,17.418,,8,0,8,2
17.42,17.42,,0,0,0,0
17.420,17.420,,8,0,8,2
17.424,17.424,,8,0,8,2
17.428,17.428,,8,0,8,2
17.426,17.426,,14,0,14,0
17.430,17.430,,8,0,8,2
17.432,17.432,,8,0,8,2
17.433,17.433,,0,0,0,0
21M.421,21M.421,,0,0,0,0
17.445,17.445,,0,0,0,0
17.447,17.447,,0,0,0,0
21G.221,21G.221,,8,0,8,2
21L.007,21L.007,,0,0,0,0
17.506,17.506,,8,0,8,2
4.S47,4.S47,,8,0,8,2
17.515,17.515,,0,0,0,0
17.516,17.516,,8,0,8,2
17.524,17.524,,8,0,8,2
17.53,17.53,,0,0,0,0
17.537,17.537,,0,0,0,0
21G.220,21G.220,,0,0,0,0
15.438,15.438,,5,0,5,0
12.717,12.717,,8,0,8,2
17.55,17.55,,0,0,0,0
17.56,17.56,,0,0,0,0
24.962,24.962,,6,0,6,0
17.561,17.561,,0,0,0,0
17.565,17.565,,0,0,0,0
11.S941,11.S941,,8,0,8,2
17.567,17.567,,0,0,0,0
5.351,5.351,,8,0,8,1
17.568,17.568,,8,0,8,2
17.569,17.569,,0,0,0,0
21H.245,21H.245,,0,0,0,0
17.571,17.571,,0,0,0,0
17.572,17.572,,8,0,8,2
17.578,17.578,,8,0,8,2
STS.044,STS.044,,0,0,0,0
12.001,12.001,,0,1,1,4
17.581,17.581,,0,0,0,0
15.307,15.307,,0,0,0,0
17.582,17.582,,8,0,8,2
15.949,15.949,,0,0,0,0
17.584,17.584,,8,0,8,2
17.588,17.588,,8,0,8,2
17.590,17.590,,8,0,8,2
17.591,17.591,,8,0,8,2
17.800,17.800,,8,1,9,2
WGS.229,WGS.229,,0,0,0,0
17.801,17.801,,0,0,0,0
21L.009,21L.009,,0,0,0,0
17.802,17.802,,14,0,14,0
17.803,17.803,,13,0,13,0
5.352,5.352,,4,1,5,0
16.S798,16.S798,,8,0,8,2
16.S799,16.S799,,8,0,8,2
CC.S11,CC.S11,,0,0,0,0
17.804,17.804,,14,0,14,0
21L.010,21L.010,,0,0,0,0
24.965,24.965,,8,0,8,2
17.909,17.909,,0,0,0,0
17.922,17.922,,0,0,0,0
1.69,1.69,,4,0,4,0
16.S897,16.S897,,8,0,8,2
20.S940,20.S940,,8,0,8,2
4.581,4.581,,8,0,8,2
HST.015,HST.015,,0,0,0,0
10.28L,10.28L,,13,0,13,4
24.964,24.964,,6,0,6,0
CMS.844,CMS.844,,0,0,0,0
7.342,7.342,,6,0,6,0
15.223,15.223,,0,0,0,0
17.THU,17.THU,,0,0,0,0
11.S944,11.S944,,8,0,8,2
4.162,4.162,,8,0,8,2
17.URG,17.URG,,0,0,0,0
15.S30,15.S30,,0,0,0,0
2.073,2.073,,5,0,5,0
4.580,4.580,,0,0,0,0
HST.021,HST.021,,8,0,8,2
CC.012,CC.012,,0,0,0,0
8.881,8.881,,3,0,3,0
15.481,15.481,,5,0,5,0
5.36,5.36,,0,0,0,0
11.307,11.307,,8,0,8,2
6.998,6.998,,0,0,0,0
9.14,9.14,,4,0,4,0
20.THU,20.THU,,0,0,0,0
4.583,4.583,,8,0,8,2
18.02,18.02,,8,0,8,1
20.URG,20.URG,,0,0,0,0
18.03,18.03,,8,61,69,4
18.031,18.031,,5,0,5,0
WGS.301,WGS.301,,0,0,0,0
18.032,18.032,,8,13,21,4
18.05,18.05,,8,5,13,1
17.000,17.000,,8,0,8,2
2.689,2.689,,8,0,8,2
18.04,18.04,,3,2,5,4
21G.401,21G.401,,0,0,0,0
CMS.622,CMS.622,,0,0,0,0
4.584,4.584,,8,0,8,2
21.THU,21.THU,,5,0,5,1
17.483,17.483,,8,0,8,2
18.085,18.085,,3,7,10,4
18.086,18.086,,3,0,3,4
21.THT,21.THT,,0,0,0,0
6.544,6.544,,8,0,8,2
6.545,6.545,,8,0,8,2
W,W,,0,7,7,0
15.227,15.227,,5,0,5,0
11.S946,11.S946,,8,0,8,2
24.970,24.970,,8,0,8,2
4.582,4.582,,13,0,13,0
4.163,4.163,,13,0,13,0
4.S52,4.S52,,8,0,8,2
15.445,15.445,,5,0,5,3
16.930,16.930,,6,0,6,0
22.011,22.011,,0,0,0,0
IDS.900,IDS.900,,8,0,8,2
CC.1802,CC.1802,,4,0,4,4
11.S947,11.S947,,8,0,8,2
CMS.628,CMS.628,,8,0,8,2
21M.405,21M.405,,0,0,0,0
18.102,18.102,,7,0,7,1
4.589,4.589,,8,0,8,2
STS.042,STS.042,,0,0,0,0
22.02,22.02,,4,0,4,4
18.103,18.103,,7,0,7,1
18.104,18.104,,8,0,8,0
CC.200,CC.200,,8,0,8,2
22.04,22.04,,0,0,0,0
11.S948,11.S948,,8,0,8,2
4.182,4.182,,8,0,8,2
4.591,4.591,,8,0,8,2
CC.182A,CC.182A,,4,0,4,4
18.117,18.117,,2,0,2,1
18.118,18.118,,9,0,9,2
21G.409,21G.409,,6,2,8,0
CC.210,CC.210,,8,0,8,2
18.125,18.125,,8,0,8,0
18.137,18.137,,8,0,8,2
1.714,1.714,,13,0,13,0
18.152,18.152,,7,0,7,1
6.941,6.941,,0,0,0,0
18.156,18.156,,4,0,4,0
CMS.633,CMS.633,,0,0,0,0
WGS.605,WGS.605,,8,0,8,2
WGS.400,WGS.400,,8,0,8,2
WGS.615,WGS.615,,0,0,0,0
18.175,18.175,,8,0,8,0
15.232,15.232,,0,0,0,0
11.S950,11.S950,,8,0,8,2
IDS.910,IDS.910,,8,0,8,2
18.200A,18.200A,,5,0,5,0
18.200,18.200,,5,1,6,0
9.42,9.42,,14,0,14,0
WGS.680,WGS.680,,0,0,0,0
WGS.S10,WGS.S10,,0,0,0,0
18.211,18.211,,4,0,4,4
WGS.610,WGS.610,,0,0,0,0
21M.445,21M.445,,0,0,0,0
WGS.600,WGS.600,,0,0,0,0
18.219,18.219,,8,0,8,2
CC.802,CC.802,,5,0,5,4
IDS.950,IDS.950,,0,0,0,0
WGS.645,WGS.645,,0,0,0,0
8.971,8.971,,8,0,8,2
WGS.640,WGS.640,,0,0,0,0
14.54,14.54,,2,0,2,3
18.327,18.327,,8,0,8,2
CC.S20,CC.S20,,0,0,0,0
SP.801,SP.801,,5,0,5,0
SP.800,SP.800,,0,0,0,0
18.330,18.330,,3,0,3,4
2.014,2.014,,15,0,15,4
8.962,8.962,,3,0,3,4
21M.862,21M.862,,0,0,0,0
WGS.700,WGS.700,,0,0,0,0
CMS.790,CMS.790,,8,0,8,2
WGS.UR,WGS.UR,,8,0,8,2
21W.026,21W.026,,0,0,0,0
12.340,12.340,,4,0,4,4
WGS.109,WGS.109,,0,0,0,0
18.062,18.062,,0,1,1,1
ESD.THG,ESD.THG,,8,0,8,2
4.601,4.601,,0,0,0,0
9.20,9.20,,3,1,4,0
11.S953,11.S953,,8,0,8,2
CMS.796,CMS.796,,8,0,8,2
ES.011,ES.011,,0,0,0,0
IDS.960,IDS.960,,0,0,0,0
18.701,18.701,,15,13,28,1
22.05,22.05,,3,0,3,4
18.355,18.355,,8,0,8,0
18.357,18.357,,16,0,16,0
18.367,18.367,,8,0,8,2
ES.113,ES.113,,0,0,0,0
4.602,4.602,,0,0,0,0
21M.460,21M.460,,0,0,0,0
STS.THT,STS.THT,,0,0,0,0
ES.1801,ES.1801,,0,0,0,0
18.384,18.384,,15,0,15,0
22.055,22.055,,8,0,8,2
18.397,18.397,,0,0,0,0
6.823,6.823,,4,0,4,0
11.002J,11.002J,,0,1,1,3
11.S954,11.S954,,8,0,8,2
CMS.791,CMS.791,,7,0,7,0
22.06,22.06,,4,1,5,0
4.603,4.603,,0,0,0,0
ES.200,ES.200,,8,0,8,2
12.349,12.349,,2,0,2,4
9.26,9.26,,5,0,5,3
18.417,18.417,,12,0,12,0
22.071,22.071,,5,0,5,0
2.372,2.372,,0,1,1,4
ES.182A,ES.182A,,8,0,8,1
8.982,8.982,,8,0,8,2
2.04A,2.04A,,4,1,5,0
22.091,22.091,,8,0,8,2
ES.210,ES.210,,8,0,8,2
HST.723,HST.723,,8,0,8,2
11.S955,11.S955,,8,0,8,2
17.202,17.202,,8,0,8,2
8.S301,8.S301,,8,0,8,2
22.093,22.093,,9,0,9,2
16.984,16.984,,0,0,0,0
15.372,15.372,,0,0,0,0
4.605,4.605,,0,0,0,0
18.455,18.455,,14,0,14,0
18.510,18.510,,0,1,1,1
PERMISSION.,PERMISSION.,,0,1,1,4
22.11,22.11,,11,0,11,0
17.251,17.251,,13,0,13,0
18.515,18.515,,8,0,8,2
7.349,7.349,,6,0,6,0
6.057,6.057,,0,0,0,0
18.600,18.600,,8,7,15,1
22.13,22.13,,13,0,13,0
2.06,2.06,,4,8,12,4
MAS.665,MAS.665,,8,0,8,2
18.642,18.642,,4,0,4,1
18.999,18.999,,8,0,8,2
9.33,9.33,,0,0,0,0
22.12,22.12,,12,0,12,0
22.14,22.14,,12,0,12,2
15.3781,15.3781,,8,0,8,2
4.607,4.607,,12,0,12,0
12.163,12.163,,11,0,11,4
8.298,8.298,,8,0,8,2
11.S957,11.S957,,8,0,8,2
17.264,17.264,,8,0,8,2
22.15,22.15,,12,0,12,0
22.211,22.211,,4,1,5,0
17.265,17.265,,0,0,0,0
15.S08,15.S08,,8,0,8,2
22.212,22.212,,3,0,3,0
18.721,18.721,,2,0,2,1
18.727,18.727,,6,0,6,0
11.S958,11.S958,,8,0,8,2
6.980,6.980,,0,0,0,0
18.748,18.748,,8,0,8,2
18.747,18.747,,6,0,6,0
18.745,18.745,,6,0,6,0
18.755,18.755,,6,0,6,1
18.781,18.781,,0,0,0,0
18.783,18.783,,15,0,15,0
15.393,15.393,,0,0,0,0
18.785,18.785,,6,0,6,0
17.905,17.905,,0,0,0,0
7.37,7.37,,13,0,13,4
16.S198,16.S198,,8,0,8,2
15.S10,15.S10,,8,0,8,2
18.786,18.786,,5,0,5,0
8.S10,8.S10,,0,0,0,0
18.787,18.787,,8,0,8,2
18.821,18.821,,0,0,0,0
18.901,18.901,,15,2,17,1
18.904,18.904,,5,0,5,0
15.397,15.397,,0,0,0,0
18.906,18.906,,6,0,6,0
18.905,18.905,,3,0,3,1
7.391,7.391,,0,0,0,0
18.917,18.917,,6,0,6,0
21G.306,21G.306,,13,0,13,3
18.919,18.919,,6,0,6,0
18.937,18.937,,8,0,8,2
15.662,15.662,,0,0,0,0
2.092,2.092,,2,0,2,4
18.950,18.950,,7,0,7,1
8.S30,8.S30,,0,0,0,0
15.S11,15.S11,,8,0,8,2
IDS.437,IDS.437,,8,0,8,2
21M.410,21M.410,,0,0,0,0
4.THG,4.THG,,8,1,9,7
11.384,11.384,,8,0,8,2
18.S096,18.S096,,8,0,8,2
18.S097,18.S097,,8,0,8,2
7.410,7.410,,8,0,8,2
18.S996,18.S996,,8,0,8,2
10.THG,10.THG,,8,0,8,2
21H.185,21H.185,,0,0,0,0
15.S12,15.S12,,8,0,8,2
15.415,15.415,,0,3,3,3
7.392,7.392,,0,0,0,0
6.775,6.775,,5,0,5,0
15.282,15.282,,0,0,0,0
18.S995,18.S995,,8,0,8,2
20.001,20.001,,0,0,0,0
20.002,20.002,,0,0,0,0
20.385,20.385,,0,0,0,0
20.102,20.102,,3,0,3,4
11.385,11.385,,5,0,5,0
20.109,20.109,,5,1,6,4
8.S50,8.S50,,0,0,0,0
22.081,22.081,,8,0,8,2
20.200,20.200,,8,0,8,2
20.201,20.201,,8,0,8,2
20.202,20.202,,8,0,8,2
ES.S11,ES.S11,,0,0,0,0
16.S298,16.S298,,8,0,8,2
10.THU,10.THU,,0,0,0,0
7.499,7.499,,3,0,3,3
20.213,20.213,,12,0,12,0
20.207,20.207,,2,0,2,4
9.S918,9.S918,,8,0,8,2
2.071,2.071,,4,0,4,0
11.386,11.386,,5,0,5,0
ES.S31,ES.S31,,0,0,0,0
15.S14,15.S14,,8,0,8,2
15.431,15.431,,6,0,6,0
12.214,12.214,,5,0,5,0
16.S299,16.S299,,8,0,8,2
20.300,20.300,,8,0,8,2
15.283,15.283,,0,0,0,0
18.S997,18.S997,,8,0,8,2
15.4311,15.4311,,5,0,5,0
ES.S50,ES.S50,,0,0,0,0
15.284,15.284,,0,0,0,0
6.100,6.100,,0,0,0,0
ES.S60,ES.S60,,0,0,0,0
11.387,11.387,,8,0,8,2
9.012,9.012,,8,0,8,2
12.307,12.307,,2,0,2,4
16.S398,16.S398,,8,0,8,2
22.912,22.912,,0,0,0,0
14.06,14.06,,2,3,5,3
18.S998,18.S998,,8,0,8,2
2.852,2.852,,14,0,14,0
MAS.826,MAS.826,,8,0,8,0
12.310,12.310,,2,0,2,4
7.41,7.41,,4,0,4,0
15.S16,15.S16,,8,0,8,2
20.465,20.465,,3,0,3,3
8.THU,8.THU,,0,0,0,0
14.05,14.05,,3,0,3,3
20.475,20.475,,12,0,12,4
20.380,20.380,,4,0,4,4
22.921,22.921,,0,0,0,0
12.315,12.315,,14,0,14,0
18.THG,18.THG,,8,0,8,2
2.853,2.853,,4,0,4,0
16.S498,16.S498,,8,0,8,2
11.002,11.002,,0,0,0,0
22.93,22.93,,0,0,0,0
9.01,9.01,,0,6,6,3
9.63,9.63,,3,0,3,0
20.440,20.440,,8,1,9,2
WGS.URG,WGS.URG,,8,0,8,2
15.454,15.454,,0,0,0,0
20.450,20.450,,10,0,10,2
6.336,6.336,,6,0,6,0
15.S18,15.S18,,8,0,8,2
16.225,16.225,,8,0,8,2
22.94,22.94,,0,0,0,0
2.098,2.098,,2,0,2,1
18.UR,18.UR,,8,0,8,2
15.792,15.792,,0,0,0,0
20.560,20.560,,8,0,8,2
20.902,20.902,,8,0,8,2
20.903,20.903,,8,0,8,2
20.920,20.920,,0,0,0,0
20.950,20.950,,8,0,8,2
12.411,12.411,,7,0,7,0
20.951,20.951,,8,0,8,2
21L.310,21L.310,,0,0,0,0
20.960,20.960,,8,0,8,2
20.BME,20.BME,,0,0,0,0
15.S19,15.S19,,8,0,8,2
20.S900,20.S900,,8,0,8,2
20.S901,20.S901,,0,0,0,0
21G.072,21G.072,,0,0,0,0
22.62,22.62,,4,0,4,0
11.004,11.004,,0,0,0,0
7.433,7.433,,8,0,8,2
2.682,2.682,,5,0,5,0
22.63,22.63,,8,0,8,2
9.77,9.77,,4,0,4,3
2.12,2.12,,5,0,5,0
14.770,14.770,,0,0,0,0
12.338,12.338,,8,0,8,2
14.137,14.137,,0,0,0,0
20.S947,20.S947,,8,0,8,2
7.434,7.434,,8,0,8,2
11.405,11.405,,8,0,8,2
9.901,9.901,,0,0,0,0
22.67,22.67,,7,0,7,0
20.UR,20.UR,,0,0,0,0
9.85,9.85,,3,1,4,0
9.014,9.014,,0,0,0,0
21.UR,21.UR,,0,0,0,0
16.S599,16.S599,,8,0,8,2
9.91,9.91,,0,0,0,0
21.URG,21.URG,,0,0,0,0
SCM.263,SCM.263,,0,0,0,0
22.01,22.01,,0,1,1,4
9.921,9.921,,8,0,8,2
22.012,22.012,,0,0,0,0
9.919,9.919,,0,0,0,0
15.373,15.373,,0,0,0,0
15.434,15.434,,6,1,7,0
2.14,2.14,,4,1,5,0
9.S52,9.S52,,0,0,0,0
STS.087,STS.087,,0,0,0,0
9.95,9.95,,0,0,0,0
21M.603,21M.603,,0,0,0,0
15.4341,15.4341,,5,0,5,0
9.97,9.97,,0,0,0,0
WGS.115,WGS.115,,0,0,0,0
7.436,7.436,,8,0,8,2
15.436,15.436,,6,0,6,0
5.062,5.062,,4,0,4,0
22.09,22.09,,4,0,4,0
21L.325,21L.325,,0,0,0,0
SCM.264,SCM.264,,0,0,0,0
15.S22,15.S22,,8,0,8,2
21M.604,21M.604,,0,0,0,0
22.213,22.213,,3,0,3,0
22.251,22.251,,4,0,4,0
21G.103,21G.103,,13,0,13,0
22.312,22.312,,10,1,11,4
22.315,22.315,,8,0,8,2
7.438,7.438,,8,0,8,2
9.09,9.09,,0,2,2,3
22.38,22.38,,8,0,8,2
22.39,22.39,,2,0,2,4
17.450,17.450,,8,0,8,2
22.901,22.901,,8,0,8,2
12.114,12.114,,0,1,1,0
17.468,17.468,,8,0,8,2
HST.584,HST.584,,8,0,8,2
15.S23,15.S23,,8,0,8,2
22.911,22.911,,0,0,0,0
22.615,22.615,,7,0,7,0
21G.105,21G.105,,14,0,14,0
17.473,17.473,,0,0,0,0
12.333,12.333,,11,0,11,4
21G.107,21G.107,,8,0,8,2
22.814,22.814,,0,0,0,0
22.S094,22.S094,,0,0,0,0
15.846,15.846,,5,0,5,0
17.478,17.478,,8,0,8,2
21G.717J,21G.717J,,0,1,1,3
17.480,17.480,,8,0,8,2
6.820,6.820,,5,0,5,0
22.616,22.616,,5,0,5,0
22.617,22.617,,12,0,12,0
17.484,17.484,,8,0,8,2
21G.109,21G.109,,14,0,14,0
22.78,22.78,,8,0,8,2
21G.113,21G.113,,13,1,14,3
22.812,22.812,,8,0,8,2
6.826,6.826,,8,0,8,2
17.50,17.50,,0,0,0,0
15.941,15.941,,0,0,0,0
15.467,15.467,,5,0,5,0
15.026,15.026,,11,0,11,3
7.411,7.411,,8,0,8,2
2.131,2.131,,8,0,8,2
WGS.142,WGS.142,,0,0,0,0
12.372,12.372,,8,0,8,2
11.431,11.431,,8,1,9,6
12.373,12.373,,3,0,3,4
12.377,12.377,,8,0,8,2
17.523,17.523,,0,0,0,0
2.122,2.122,,2,0,2,4
21H.226,21H.226,,0,0,0,0
9.19,9.19,,12,0,12,3
EC.716,EC.716,,0,0,0,0
2.690,2.690,,2,0,2,14
12.387,12.387,,0,0,0,0
12.422,12.422,,13,0,13,0
16.83,16.83,,8,0,8,2
12.390,12.390,,5,0,5,0
10.03,10.03,,0,0,0,0
12.44,12.44,,0,0,0,0
12.440,12.440,,8,0,8,2
12.441,12.441,,8,0,8,2
12.400,12.400,,8,0,8,1
12.443,12.443,,8,0,8,2
12.445,12.445,,8,0,8,2
12.446,12.446,,0,0,0,0
WGS.150,WGS.150,,0,0,0,0
12.449,12.449,,8,0,8,2
12.450,12.450,,8,0,8,2
14.129,14.129,,13,0,13,0
12.451,12.451,,8,0,8,2
12.453,12.453,,8,0,8,2
12.454,12.454,,8,0,8,2
12.456,12.456,,8,0,8,2
22.S905,22.S905,,8,0,8,2
12.460,12.460,,8,0,8,2
9.S916,9.S916,,8,0,8,2
12.461,12.461,,8,0,8,2
12.475,12.475,,8,0,8,2
2.979,2.979,,0,0,0,0
12.409,12.409,,0,0,0,0
6.003,6.003,,3,13,16,4
11.432,11.432,,3,0,3,6
2.681,2.681,,16,0,16,0
1.S979,1.S979,,8,0,8,2
2.98,2.98,,0,0,0,0
21L.431,21L.431,,0,0,0,0
12.492,12.492,,0,0,0,0
12.510,12.510,,6,0,6,0
2.981,2.981,,0,0,0,0
2.141,2.141,,8,0,8,2
22.THT,22.THT,,0,0,0,0
22.S092,22.S092,,0,0,0,0
12.525,12.525,,8,0,8,2
22.S093,22.S093,,0,0,0,0
21A.104,21A.104,,0,0,0,0
21L.435,21L.435,,0,0,0,0
2.20,2.20,,6,4,10,4
22.S902,22.S902,,8,0,8,2
2.99,2.99,,0,0,0,0
-,-,,0,1,1,2
/,/,,0,1,1,2
22.S904,22.S904,,8,0,8,2
16.395,16.395,,13,0,13,0
6.829,6.829,,12,0,12,0
12.552,12.552,,5,0,5,0
12.540,12.540,,3,0,3,4
12.560,12.560,,8,0,8,2
12.570,12.570,,8,0,8,2
12.561,12.561,,8,0,8,2
2.990,2.990,,0,0,0,0
12.580,12.580,,8,0,8,2
12.581,12.581,,8,0,8,2
22.THG,22.THG,,8,0,8,2
IDS.970,IDS.970,,0,0,0,0
11.308,11.308,,8,0,8,2
MAS.S67,MAS.S67,,8,0,8,2
12.603,12.603,,8,0,8,2
12.602,12.602,,2,0,2,4
12.611,12.611,,8,0,8,2
18.434,18.434,,5,0,5,0
12.650,12.650,,8,0,8,2
12.652,12.652,,8,0,8,2
12.690,12.690,,8,0,8,2
22.THU,22.THU,,4,0,4,1
12.691,12.691,,8,0,8,2
18.THU,18.THU,,0,0,0,0
2.993,2.993,,0,0,0,0
12.701,12.701,,0,0,0,0
12.703,12.703,,0,0,0,0
12.708,12.708,,8,0,8,2
22.UR,22.UR,,0,0,0,0
12.710,12.710,,8,0,8,2
12.712,12.712,,8,0,8,2
12.714,12.714,,5,0,5,0
12.716,12.716,,13,0,13,0
12.718,12.718,,8,0,8,2
12.721,12.721,,8,0,8,2
5.62,5.62,,2,0,2,4
12.722,12.722,,8,0,8,2
12.723,12.723,,8,0,8,2
12.724,12.724,,8,0,8,2
12.725,12.725,,8,0,8,2
12.726,12.726,,8,0,8,2
12.730,12.730,,8,0,8,2
24.00,24.00,,0,0,0,0
12.731,12.731,,8,0,8,2
HST.141,HST.141,,4,0,4,0
12.732,12.732,,8,0,8,2
12.733,12.733,,8,0,8,2
12.735,12.735,,8,0,8,2
12.736,12.736,,8,0,8,2
4.210,4.210,,0,0,0,0
15.433,15.433,,0,1,1,0
11.403,11.403,,8,0,8,2
21W.036,21W.036,,0,0,0,0
11.016,11.016,,0,0,0,0
11.435,11.435,,0,0,0,0
21L.432,21L.432,,0,0,0,0
12.739,12.739,,0,0,0,0
12.740,12.740,,8,0,8,2
4.288,4.288,,8,0,8,2
12.742,12.742,,8,0,8,2
12.747,12.747,,8,0,8,2
12.743,12.743,,2,0,2,4
12.746,12.746,,8,0,8,2
4.214,4.214,,8,0,8,2
22.URG,22.URG,,0,0,0,0
4.280,4.280,,8,0,8,2
12.749,12.749,,8,0,8,2
24.06,24.06,,0,0,0,0
12.751,12.751,,8,0,8,2
12.752,12.752,,8,0,8,2
4.270,4.270,,0,0,0,0
12.753,12.753,,8,0,8,2
12.754,12.754,,8,0,8,2
24.07,24.07,,0,0,0,0
12.755,12.755,,8,0,8,2
12.756,12.756,,8,0,8,2
IDS.S01,IDS.S01,,8,0,8,2
4.287,4.287,,8,0,8,2
12.757,12.757,,8,0,8,2
12.758,12.758,,8,0,8,2
12.759,12.759,,8,0,8,2
12.760,12.760,,8,0,8,2
4.286,4.286,,0,0,0,0
12.761,12.761,,8,0,8,2
12.770,12.770,,8,0,8,2
12.771,12.771,,8,0,8,2
11.234,11.234,,0,0,0,0
24.09,24.09,,0,0,0,0
4.292,4.292,,8,0,8,2
6.S963,6.S963,,0,0,0,0
16.31,16.31,,0,2,2,1
HST.146,HST.146,,8,0,8,2
4.293,4.293,,8,0,8,2
4.294,4.294,,8,0,8,2
4.617,4.617,,8,0,8,2
24.115,24.115,,0,0,0,0
16.400,16.400,,15,0,15,0
12.801,12.801,,5,1,6,0
4.301,4.301,,0,0,0,0
12.803,12.803,,6,0,6,0
12.802,12.802,,13,1,14,0
24.120,24.120,,0,0,0,0
12.808,12.808,,8,0,8,2
12.442,12.442,,8,0,8,2
24.230,24.230,,0,0,0,0
12.810,12.810,,5,0,5,0
21H.230,21H.230,,0,0,0,0
4.307,4.307,,14,0,14,0
24.191,24.191,,0,0,0,0
11.309,11.309,,0,0,0,0
21H.238,21H.238,,0,0,0,0
4.312,4.312,,14,0,14,0
24.211,24.211,,0,0,0,0
4.222,4.222,,8,0,8,2
24.02,24.02,,0,0,0,0
24.222,24.222,,0,0,0,0
24.420,24.420,,0,0,0,0
4.314,4.314,,14,0,14,0
24.201,24.201,,0,0,0,0
12.830,12.830,,6,0,6,0
SCM.800,SCM.800,,0,0,0,0
16.401,16.401,,0,0,0,0
11.S966,11.S966,,8,0,8,2
4.221,4.221,,8,2,10,2
IDS.526,IDS.526,,0,0,0,0
24.221,24.221,,0,0,0,0
21H.260,21H.260,,0,0,0,0
4.322,4.322,,0,0,0,0
12.863,12.863,,13,0,13,0
24.236,24.236,,0,0,0,0
12.866,12.866,,3,0,3,0
12.951,12.951,,8,0,8,2
12.870,12.870,,0,0,0,0
11.438,11.438,,3,0,3,3
4.217,4.217,,0,0,0,0
12.910,12.910,,0,0,0,0
12.960,12.960,,8,0,8,2
12.970,12.970,,8,0,8,2
SCM.803,SCM.803,,0,0,0,0
12.S488,12.S488,,8,0,8,2
12.S490,12.S490,,8,0,8,2
12.S489,12.S489,,8,0,8,2
12.S491,12.S491,,8,0,8,2
4.225,4.225,,8,0,8,2
11.127,11.127,,0,0,0,0
16.S598,16.S598,,8,0,8,2
8.226,8.226,,10,0,10,4
STS.025,STS.025,,0,0,0,0
21H.319,21H.319,,0,0,0,0
HST.151,HST.151,,3,0,3,4
21W.736,21W.736,,0,0,0,0
24.05,24.05,,0,0,0,0
16.391,16.391,,0,1,1,0
21H.315,21H.315,,0,0,0,0
11.129,11.129,,4,0,4,0
12.S595,12.S595,,0,0,0,0
12.S681,12.S681,,8,0,8,2
12.THU,12.THU,,6,0,6,0
4.231,4.231,,8,0,8,2
21H.331,21H.331,,0,0,0,0
HST.161,HST.161,,4,0,4,0
1.107,1.107,,3,1,4,1
HST.508,HST.508,,8,0,8,2
11.137,11.137,,0,0,0,0
6.781,6.781,,15,0,15,0
8.231J,8.231J,,0,1,1,4
11.S970,11.S970,,8,0,8,2
4.232,4.232,,8,0,8,2
14.130,14.130,,2,0,2,3
4.236,4.236,,8,0,8,2
1.361,1.361,,0,1,1,13
11.139,11.139,,0,0,0,0
12.481,12.481,,2,0,2,0
15.516,15.516,,8,2,10,3
14.160,14.160,,4,0,4,0
14.18,14.18,,7,0,7,0
14.191,14.191,,8,0,8,2
14.193,14.193,,2,0,2,3
14.195,14.195,,4,0,4,0
17.811,17.811,,8,0,8,2
12.482,12.482,,5,0,5,0
14.199,14.199,,0,0,0,0
11.439,11.439,,4,0,4,3
",",",",,0,1,1,0
17.806,17.806,,14,0,14,0
7.95,7.95,,2,0,2,3
15.521,15.521,,4,0,4,0
17.830,17.830,,8,0,8,2
12.486,12.486,,8,0,8,2
11.140,11.140,,0,0,0,0
21H.214,21H.214,,0,0,0,0
17.831,17.831,,0,0,0,0
14.07,14.07,,2,0,2,3
HST.163,HST.163,,7,0,7,0
14.21,14.21,,4,0,4,0
10.302,10.302,,11,9,20,4
14.26,14.26,,4,0,4,0
14.27,14.27,,3,0,3,3
IDS.S31,IDS.S31,,0,0,0,0
14.271,14.271,,4,0,4,0
18.112,18.112,,7,2,9,1
17.850,17.850,,8,0,8,2
15.455,15.455,,0,0,0,0
11.450,11.450,,0,0,0,0
14.272,14.272,,5,0,5,0
4.635,4.635,,0,0,0,0
10.32,10.32,,2,0,2,4
4.352,4.352,,12,0,12,0
14.273,14.273,,5,0,5,0
14.281,14.281,,4,0,4,0
8.251,8.251,,3,0,3,4
14.282,14.282,,4,0,4,0
14.283,14.283,,5,0,5,0
17.835,17.835,,12,0,12,0
14.284,14.284,,5,0,5,0
14.30,14.30,,8,4,12,3
17.878,17.878,,8,0,8,2
14.31,14.31,,8,0,8,1
15.522,15.522,,5,0,5,0
14.32,14.32,,5,3,8,3
14.33,14.33,,3,0,3,3
4.354,4.354,,0,0,0,0
10.31,10.31,,13,0,13,3
14.36,14.36,,5,0,5,0
17.901,17.901,,0,0,0,0
14.381,14.381,,2,0,2,3
11.455,11.455,,0,0,0,0
14.382,14.382,,13,0,13,0
4.356,4.356,,15,0,15,0
17.902,17.902,,0,0,0,0
14.384,14.384,,14,0,14,0
14.386,14.386,,6,0,6,0
6.006,6.006,,3,6,9,1
14.385,14.385,,14,0,14,0
17.903,17.903,,0,0,0,0
14.389,14.389,,6,0,6,0
14.392,14.392,,2,0,2,3
14.41,14.41,,4,0,4,0
11.144,11.144,,8,0,8,2
10.34,10.34,,8,0,8,2
15.470,15.470,,0,0,0,0
14.42,14.42,,4,0,4,0
15.6181,15.6181,,0,0,0,0
15.535,15.535,,7,0,7,3
14.44,14.44,,5,0,5,0
24.111,24.111,,0,0,0,0
17.906,17.906,,0,0,0,0
4.361,4.361,,14,0,14,0
10.345,10.345,,12,0,12,0
6.150,6.150,,8,0,8,2
IDS.THG,IDS.THG,,8,0,8,2
14.08,14.08,,4,0,4,0
17.908,17.908,,0,0,0,0
21H.343,21H.343,,0,0,0,0
4.368,4.368,,6,0,6,0
12.420,12.420,,12,0,12,0
17.910,17.910,,0,0,0,0
5.46,5.46,,4,0,4,0
24.112,24.112,,0,0,0,0
15.472,15.472,,0,0,0,0
17.911,17.911,,0,0,0,0
4.373,4.373,,14,0,14,0
11.145,11.145,,4,0,4,0
HST.936,HST.936,,0,0,0,0
4.388,4.388,,8,1,9,7
6.867,6.867,,3,0,3,1
14.452,14.452,,2,2,4,3
14.46,14.46,,0,0,0,0
14.454,14.454,,2,2,4,3
11.458,11.458,,0,0,0,0
14.461,14.461,,2,0,2,3
17.923,17.923,,5,0,5,0
4.390,4.390,,8,0,8,2
14.582,14.582,,5,0,5,0
HST.200,HST.200,,8,0,8,2
4.391,4.391,,8,0,8,2
17.955,17.955,,8,0,8,2
14.661,14.661,,2,0,2,3
4.389,4.389,,2,0,2,7
11.246,11.246,,8,0,8,2
17.954,17.954,,8,0,8,2
4.392,4.392,,8,0,8,2
5.47,5.47,,2,0,2,3
STS.260,STS.260,,0,0,0,0
14.73,14.73,,0,0,0,0
6.251J,6.251J,,0,1,1,12
4.393,4.393,,8,0,8,2
14.75,14.75,,2,0,2,3
6.436J,6.436J,,0,1,1,12
HST.482,HST.482,,6,0,6,1
4.394,4.394,,8,0,8,2
14.771,14.771,,2,0,2,3
14.772,14.772,,2,0,2,3
14.773,14.773,,6,0,6,0
4.401,4.401,,0,1,1,1
4.411,4.411,,2,0,2,4
16.S686,16.S686,,8,0,8,2
5.512,5.512,,3,0,3,0
7.492,7.492,,0,1,1,3
4.430,4.430,,11,0,11,0
1.091,1.091,,8,0,8,2
5.511,5.511,,4,1,5,0
14.THG,14.THG,,8,0,8,2
14.THU,14.THU,,4,0,4,0
14.UR,14.UR,,5,0,5,0
14.URG,14.URG,,5,0,5,0
15.002,15.002,,0,0,0,0
15.003,15.003,,0,0,0,0
15.010,15.010,,0,0,0,0
15.0111,15.0111,,0,0,0,0
15.012,15.012,,0,0,0,0
7.493,7.493,,13,1,14,0
17.S914,17.S914,,0,0,0,0
HST.201,HST.201,,8,0,8,2
15.017,15.017,,0,0,0,0
17.S916,17.S916,,0,0,0,0
24.711,24.711,,8,0,8,2
15.024,15.024,,8,0,8,2
14.10,14.10,,2,0,2,3
16.831,16.831,,8,0,8,2
15.027,15.027,,0,0,0,0
17.S918,17.S918,,0,0,0,0
24.805,24.805,,8,0,8,2
15.0341,15.0341,,0,0,0,0
17.S919,17.S919,,0,0,0,0
24.810,24.810,,8,0,8,2
15.053,15.053,,12,0,12,0
15.060,15.060,,8,2,10,10
15.0621,15.0621,,6,0,6,0
3.42,3.42,,3,0,3,0
24.130,24.130,,0,0,0,0
17.S952,17.S952,,8,0,8,2
HST.202,HST.202,,7,0,7,0
24.891,24.891,,11,0,11,2
6.033,6.033,,2,5,7,1
17.THG,17.THG,,8,0,8,2
5.53,5.53,,2,1,3,4
11.001,11.001,,0,0,0,0
15.564,15.564,,0,0,0,0
15.068,15.068,,5,0,5,0
24.9000,24.9000,,0,0,0,0
HST.S16,HST.S16,,0,0,0,0
12.521,12.521,,8,0,8,2
15.0711,15.0711,,5,0,5,0
15.071,15.071,,6,0,6,0
17.THT,17.THT,,14,0,14,0
15.0741,15.0741,,6,0,6,0
15.079,15.079,,8,0,8,1
15.075,15.075,,9,0,9,0
15.077,15.077,,5,0,5,1
15.0791,15.0791,,8,0,8,1
12.515,12.515,,6,0,6,0
15.083,15.083,,14,0,14,0
24.903,24.903,,5,2,7,0
10.40,10.40,,5,0,5,0
18.155,18.155,,6,0,6,0
21H.URG,21H.URG,,0,0,0,0
15.086,15.086,,2,1,3,4
15.087,15.087,,4,0,4,1
15.089,15.089,,0,0,0,0
11.303,11.303,,8,0,8,2
10.424,10.424,,5,0,5,0
15.096,15.096,,0,0,0,0
15.097,15.097,,8,0,8,2
15.098,15.098,,6,0,6,0
15.099,15.099,,6,0,6,0
HST.973,HST.973,,0,0,0,0
15.141,15.141,,8,0,8,2
15.216,15.216,,0,0,0,0
15.220,15.220,,0,0,0,0
15.221,15.221,,0,0,0,0
15.616,15.616,,0,0,0,0
15.225,15.225,,0,0,0,0
14.12,14.12,,3,0,3,3
15.228,15.228,,5,0,5,0
5.95,5.95,,0,0,0,0
15.229,15.229,,0,0,0,0
15.233,15.233,,0,0,0,0
15.248,15.248,,0,0,0,0
15.268,15.268,,0,0,0,0
15.269,15.269,,0,0,0,0
15.270,15.270,,0,0,0,0
10.43,10.43,,0,0,0,0
21M.624,21M.624,,13,0,13,0
15.277,15.277,,0,0,0,0
15.278,15.278,,0,0,0,0
15.279,15.279,,0,0,0,0
15.281,15.281,,16,0,16,0
24.192,24.192,,0,0,0,0
1.984,1.984,,8,0,8,2
HST.299,HST.299,,8,0,8,2
10.450,10.450,,2,0,2,4
18.404,18.404,,7,0,7,0
15.648,15.648,,0,0,0,0
10.466,10.466,,4,0,4,0
15.286,15.286,,0,0,0,0
15.289,15.289,,8,0,8,2
15.301,15.301,,0,0,0,0
15.304,15.304,,0,0,0,0
15.305,15.305,,8,0,8,2
5.56,5.56,,11,0,11,0
15.309,15.309,,0,0,0,0
15.310,15.310,,0,0,0,0
15.311,15.311,,8,0,8,2
15.312,15.312,,0,0,0,0
7.494,7.494,,8,0,8,2
10.467,10.467,,2,0,2,4
15.316,15.316,,0,0,0,0
15.317,15.317,,0,0,0,0
15.318,15.318,,13,0,13,0
15.320,15.320,,0,0,0,0
15.321,15.321,,0,0,0,0
15.322,15.322,,0,0,0,0
15.323,15.323,,0,0,0,0
15.324,15.324,,0,0,0,0
15.325,15.325,,0,0,0,0
10.489,10.489,,2,0,2,4
15.326,15.326,,5,0,5,0
HST.240,HST.240,,7,0,7,0
15.328,15.328,,0,0,0,0
15.339,15.339,,0,0,0,0
15.329,15.329,,0,0,0,0
15.341,15.341,,8,0,8,2
15.342,15.342,,8,0,8,2
15.345,15.345,,8,0,8,2
15.661,15.661,,0,0,0,0
15.347,15.347,,8,0,8,2
15.350,15.350,,0,0,0,0
15.348,15.348,,14,0,14,0
15.351,15.351,,0,0,0,0
15.S33,15.S33,,0,0,0,0
15.356,15.356,,0,0,0,0
15.357,15.357,,0,0,0,0
15.360,15.360,,8,0,8,2
15.358,15.358,,6,0,6,0
15.361,15.361,,0,0,0,0
15.363,15.363,,0,0,0,0
15.364,15.364,,0,0,0,0
15.3641,15.3641,,0,0,0,0
HST.978,HST.978,,0,0,0,0
15.366,15.366,,5,0,5,11
15.665,15.665,,8,0,8,2
4.507,4.507,,0,0,0,0
15.368,15.368,,0,0,0,0
MAS.S72,MAS.S72,,8,0,8,2
4.302,4.302,,6,0,6,0
4.511,4.511,,8,0,8,2
18.01,18.01,,0,0,0,0
18.022,18.022,,8,0,8,1
15.668,15.668,,0,0,0,0
9.60,9.60,,2,0,2,3
14.121,14.121,,2,6,8,3
18.01A,18.01A,,0,0,0,0
12.448,12.448,,8,0,8,2
5.68,5.68,,8,0,8,0
5.561,5.561,,4,0,4,4
15.369,15.369,,5,1,6,0
18.02A,18.02A,,8,0,8,1
15.669,15.669,,12,0,12,0
15.374,15.374,,0,0,0,0
MAS.664,MAS.664,,0,0,0,0
15.385,15.385,,0,0,0,0
15.386,15.386,,0,0,0,0
15.387,15.387,,0,0,0,0
15.3901,15.3901,,0,0,0,0
15.392,15.392,,7,0,7,0
14.123,14.123,,3,0,3,3
15.398,15.398,,0,0,0,0
15.399,15.399,,0,0,0,0
15.3991,15.3991,,0,0,0,0
15.401,15.401,,0,3,3,3
15.402,15.402,,5,4,9,0
15.676,15.676,,8,0,8,2
15.403,15.403,,0,0,0,0
5.60,5.60,,2,15,17,4
15.414,15.414,,3,5,8,0
20.S948,20.S948,,8,0,8,2
15.417,15.417,,0,0,0,0
15.425,15.425,,4,0,4,0
5.07,5.07,,4,9,13,4
14.122,14.122,,2,3,5,3
18.06,18.06,,8,33,41,1
1.001,1.001,,0,1,1,1
15.691,15.691,,8,0,8,2
5.61,5.61,,3,8,11,4
20.S949,20.S949,,8,0,8,2
18.065,18.065,,5,0,5,0
21A.503,21A.503,,0,0,0,0
15.698,15.698,,0,0,0,0
24.915,24.915,,5,0,5,0
18.075,18.075,,2,9,11,4
15.4371,15.4371,,5,0,5,0
21L.601,21L.601,,0,0,0,0
16.S982,16.S982,,0,0,0,0
15.439,15.439,,5,0,5,0
HST.434,HST.434,,0,0,0,0
3.021,3.021,,14,0,14,0
2.680,2.680,,8,0,8,2
20.S952,20.S952,,8,0,8,2
15.447,15.447,,5,0,5,0
24.919,24.919,,0,0,0,0
15.4451,15.4451,,4,0,4,3
15.448,15.448,,0,0,0,0
15.449,15.449,,0,0,0,0
15.450,15.450,,5,0,5,0
15.452,15.452,,6,0,6,0
24.918,24.918,,11,0,11,0
15.453,15.453,,5,0,5,0
15.466,15.466,,6,0,6,0
15.456,15.456,,0,0,0,0
2.684,2.684,,0,0,0,0
20.THG,20.THG,,8,0,8,2
24.921,24.921,,11,0,11,2
21M.710,21M.710,,0,1,1,3
24.922,24.922,,11,0,11,2
MS.301,MS.301,,11,0,11,2
14.125,14.125,,4,0,4,0
24.231,24.231,,0,0,0,0
1.S991,1.S991,,8,0,8,2
15.474,15.474,,0,0,0,0
15.482,15.482,,13,0,13,0
15.483,15.483,,5,0,5,0
15.487,15.487,,5,0,5,0
21L.707,21L.707,,0,0,0,0
15.4871,15.4871,,5,0,5,0
15.491,15.491,,6,0,6,0
21G.348,21G.348,,0,0,0,0
14.124,14.124,,13,2,15,3
15.493,15.493,,6,0,6,0
24.942,24.942,,6,0,6,0
1.S992,1.S992,,8,0,8,2
15.496,15.496,,5,0,5,0
15.497,15.497,,0,0,0,0
ES.181A,ES.181A,,0,0,0,0
15.498,15.498,,5,0,5,0
15.499,15.499,,5,0,5,0
5.64,5.64,,4,0,4,4
MAS.500,MAS.500,,8,0,8,2
15.501,15.501,,0,2,2,3
15.511,15.511,,8,1,9,2
16.UR,16.UR,,0,0,0,0
15.514,15.514,,0,0,0,0
4.550,4.550,,8,0,8,2
15.515,15.515,,8,2,10,3
15.518,15.518,,5,0,5,0
18.100A,18.100A,,8,11,19,1
15.5181,15.5181,,4,0,4,0
4.542,4.542,,12,0,12,0
10.52,10.52,,4,0,4,0
24.948,24.948,,8,0,8,2
MAS.552,MAS.552,,8,0,8,2
15.539,15.539,,3,0,3,0
24.951,24.951,,8,2,10,9
24.952,24.952,,6,2,8,9
18.100P,18.100P,,8,9,17,1
4.320,4.320,,0,0,0,0
24.954,24.954,,8,0,8,2
18.100Q,18.100Q,,8,11,19,1
4.566,4.566,,13,0,13,0
24.955,24.955,,2,0,2,9
15.561,15.561,,0,0,0,0
15.565,15.565,,8,0,8,2
15.567,15.567,,8,1,9,2
24.956,24.956,,6,0,6,0
15.569,15.569,,8,0,8,2
15.570,15.570,,0,0,0,0
CMS.634,CMS.634,,0,0,0,0
15.571,15.571,,0,0,0,0
15.576,15.576,,8,0,8,2
15.615,15.615,,0,0,0,0
21L.006,21L.006,,0,0,0,0
15.617,15.617,,0,0,0,0
5.931,5.931,,4,0,4,0
15.647,15.647,,0,0,0,0
15.649,15.649,,0,0,0,0
24.961,24.961,,8,0,8,2
15.667,15.667,,8,0,8,2
15.671,15.671,,0,0,0,0
15.6721,15.6721,,8,0,8,2
10.437,10.437,,0,0,0,0
6.042J,6.042J,,0,1,1,1
4.341,4.341,,0,0,0,0
15.915,15.915,,5,0,5,0
24.967,24.967,,15,0,15,0
6.951,6.951,,5,0,5,0
10.542,10.542,,8,0,8,2
15.700,15.700,,8,0,8,2
HST.031,HST.031,,8,0,8,2
15.702,15.702,,8,0,8,2
15.701,15.701,,13,0,13,0
15.703,15.703,,8,0,8,2
15.705,15.705,,8,0,8,2
15.707,15.707,,8,0,8,2
15.708,15.708,,8,0,8,2
5.12,5.12,,8,3,11,4
15.709,15.709,,0,0,0,0
21L.018,21L.018,,0,0,0,0
15.711,15.711,,0,0,0,0
15.712,15.712,,8,0,8,2
15.713,15.713,,0,0,0,0
15.714,15.714,,8,0,8,2
15.715,15.715,,0,0,0,0
15.716,15.716,,0,0,0,0
15.717,15.717,,8,0,8,2
10.544,10.544,,3,0,3,4
15.719,15.719,,0,0,0,0
4.606,4.606,,0,0,0,0
15.720,15.720,,8,0,8,2
15.722,15.722,,8,0,8,2
15.724,15.724,,8,0,8,2
21L.020,21L.020,,0,0,0,0
15.723,15.723,,14,0,14,0
15.725,15.725,,0,0,0,0
15.726,15.726,,0,0,0,0
15.727,15.727,,14,0,14,0
15.728,15.728,,0,0,0,0
15.730,15.730,,8,1,9,2
15.732,15.732,,8,0,8,2
HST.034,HST.034,,12,0,12,0
15.731,15.731,,10,0,10,2
15.734,15.734,,8,1,9,2
15.735,15.735,,0,0,0,0
15.736,15.736,,8,0,8,2
21L.022,21L.022,,0,0,0,0
15.738,15.738,,6,0,6,0
15.737,15.737,,14,0,14,0
15.739,15.739,,0,0,0,0
21L.S92,21L.S92,,8,0,8,2
15.740,15.740,,0,0,0,0
15.761,15.761,,15,2,17,10
15.7611,15.7611,,17,0,17,0
22.S903,22.S903,,8,0,8,2
HST.718,HST.718,,2,0,2,4
4.344,4.344,,12,0,12,0
6.S063,6.S063,,0,0,0,0
10.55,10.55,,8,0,8,2
6.S064,6.S064,,3,0,3,4
21G.402,21G.402,,14,0,14,0
6.S077,6.S077,,8,0,8,2
HST.525,HST.525,,2,0,2,3
HST.S47,HST.S47,,0,0,0,0
10.551,10.551,,3,0,3,4
21L.S97,21L.S97,,0,0,0,0
2.S974,2.S974,,0,0,0,0
21H.320,21H.320,,0,0,0,0
15.768,15.768,,14,0,14,0
15.767,15.767,,10,0,10,10
15.769,15.769,,14,0,14,0
21L.THT,21L.THT,,0,0,0,0
15.772,15.772,,0,0,0,0
2.S971,2.S971,,0,0,0,0
15.775,15.775,,0,0,0,0
15.774,15.774,,13,0,13,0
15.777,15.777,,2,0,2,10
15.778,15.778,,0,0,0,0
10.555,10.555,,8,0,8,2
15.781,15.781,,8,0,8,2
24.235,24.235,,0,0,0,0
15.780,15.780,,17,0,17,0
21L.UR,21L.UR,,0,0,0,0
2.772J,2.772J,,0,1,1,4
10.56,10.56,,8,0,8,2
21L.URG,21L.URG,,0,0,0,0
21G.403,21G.403,,14,0,14,0
10.557,10.557,,6,0,6,0
10.560,10.560,,13,0,13,0
1.064,1.064,,4,0,4,0
1.068,1.068,,5,0,5,0
21L.315,21L.315,,0,0,0,0
1.070A,1.070A,,3,1,4,8
1.071,1.071,,5,0,5,0
1.070B,1.070B,,5,0,5,0
1.072,1.072,,4,0,4,0
1.073,1.073,,3,0,3,0
1.074,1.074,,3,0,3,0
21L.320,21L.320,,0,0,0,0
1.080A,1.080A,,8,1,9,1
1.78,1.78,,0,0,0,0
15.821,15.821,,0,0,0,0
2.S983,2.S983,,8,0,8,2
15.830,15.830,,8,0,8,0
15.841,15.841,,0,0,0,0
15.842,15.842,,5,0,5,0
21L.340,21L.340,,8,0,8,2
15.847,15.847,,5,0,5,0
15.871,15.871,,8,0,8,2
15.872,15.872,,5,2,7,3
21L.345,21L.345,,8,0,8,2
15.8741,15.8741,,0,0,0,0
15.878,15.878,,5,0,5,0
21L.350,21L.350,,0,0,0,0
15.902,15.902,,8,1,9,2
15.904,15.904,,13,0,13,0
21L.355,21L.355,,0,0,0,0
15.910,15.910,,0,1,1,11
12.467,12.467,,8,0,8,2
11.902,11.902,,8,0,8,2
4.610,4.610,,0,0,0,0
12.741,12.741,,8,0,8,2
4.616,4.616,,8,0,8,2
15.911,15.911,,0,0,0,0
15.912,15.912,,13,0,13,0
15.913,15.913,,0,0,0,0
15.914,15.914,,5,0,5,3
21L.449,21L.449,,0,0,0,0
15.928,15.928,,6,0,6,0
15.929,15.929,,6,0,6,0
4.622,4.622,,8,0,8,2
15.933,15.933,,13,0,13,0
21G.405,21G.405,,15,0,15,0
15.950,15.950,,0,0,0,0
21L.434,21L.434,,0,0,0,0
15.951,15.951,,0,0,0,0
15.952,15.952,,0,0,0,0
15.960,15.960,,8,0,8,2
15.961,15.961,,8,0,8,2
15.962,15.962,,8,0,8,2
15.998,15.998,,0,0,0,0
15.999,15.999,,0,0,0,0
15.S01,15.S01,,8,0,8,2
15.S03,15.S03,,8,0,8,2
1.089A,1.089A,,12,0,12,2
15.S04,15.S04,,8,0,8,2
15.S05,15.S05,,8,0,8,2
12.744,12.744,,0,0,0,0
15.S06,15.S06,,8,0,8,2
1.101,1.101,,0,0,0,0
1.106,1.106,,2,2,4,8
15.S09,15.S09,,8,0,8,2
MAS.622,MAS.622,,8,0,8,2
1.124,1.124,,11,0,11,0
15.S13,15.S13,,8,0,8,2
24.991,24.991,,8,0,8,2
1.125,1.125,,14,0,14,0
2.089,2.089,,8,0,8,2
24.253,24.253,,0,0,0,0
2.062,2.062,,2,0,2,4
15.S17,15.S17,,8,0,8,2
IDS.332,IDS.332,,8,0,8,2
15.S20,15.S20,,8,0,8,2
1.153,1.153,,3,0,3,0
15.S25,15.S25,,8,0,8,2
10.579,10.579,,0,1,1,11
1.202,1.202,,12,0,12,0
HST.516,HST.516,,8,0,8,2
4.646,4.646,,8,0,8,2
24.UR,24.UR,,0,0,0,0
1.00,1.00,,8,5,13,1
1.000,1.000,,5,4,9,0
1.010,1.010,,8,5,13,1
2.00C,2.00C,,0,0,0,0
5.70,5.70,,12,0,12,0
1.018B,1.018B,,5,0,5,0
12.471,12.471,,0,0,0,0
15.S32,15.S32,,0,0,0,0
2.718,2.718,,15,0,15,0
15.S35,15.S35,,0,0,0,0
15.S36,15.S36,,0,0,0,0
14.11,14.11,,4,0,4,0
15.S37,15.S37,,0,0,0,0
15.S38,15.S38,,0,0,0,0
15.S40,15.S40,,0,0,0,0
15.S41,15.S41,,0,0,0,0
15.S42,15.S42,,0,0,0,0
MAS.534,MAS.534,,0,0,0,0
4.648,4.648,,0,0,0,0
15.S43,15.S43,,0,0,0,0
15.085,15.085,,0,1,1,1
15.S44,15.S44,,0,0,0,0
18.116,18.116,,4,0,4,0
15.S46,15.S46,,0,0,0,0
15.S47,15.S47,,0,0,0,0
15.S52,15.S52,,8,0,8,2
15.S53,15.S53,,8,0,8,2
15.S54,15.S54,,8,0,8,2
15.S55,15.S55,,8,0,8,2
15.S56,15.S56,,8,0,8,2
10.568,10.568,,8,0,8,0
21G.717,21G.717,,0,1,1,3
10.569,10.569,,4,0,4,0
15.S67,15.S67,,8,0,8,2
15.S68,15.S68,,8,0,8,2
2.72,2.72,,4,0,4,4
15.S73,15.S73,,8,0,8,2
15.S74,15.S74,,8,0,8,2
24.401,24.401,,8,0,8,2
21G.716,21G.716,,0,1,1,3
15.URG,15.URG,,0,0,0,0
21G.740,21G.740,,0,1,1,3
HST.962,HST.962,,8,0,8,2
12.474,12.474,,8,0,8,2
21M.863,21M.863,,8,0,8,2
21M.864,21M.864,,8,0,8,2
21M.865,21M.865,,8,0,8,2
21M.S53,21M.S53,,8,0,8,2
21M.S54,21M.S54,,8,0,8,2
21M.THT,21M.THT,,8,0,8,2
21M.THU,21M.THU,,6,0,6,1
CC.220,CC.220,,0,0,0,0
21M.UR,21M.UR,,0,0,0,0
10.586,10.586,,5,0,5,0
21M.URG,21M.URG,,0,0,0,0
21W.756,21W.756,,0,0,0,0
21W.757,21W.757,,6,0,6,0
21W.758,21W.758,,8,0,8,2
21W.759,21W.759,,0,0,0,0
21W.760,21W.760,,0,0,0,0
21W.761,21W.761,,0,0,0,0
21W.762,21W.762,,0,0,0,0
21W.763,21W.763,,0,0,0,0
15.S60,15.S60,,8,0,8,2
21W.764,21W.764,,0,0,0,0
CMS.612,CMS.612,,0,0,0,0
CMS.616,CMS.616,,0,0,0,0
5.111,5.111,,0,0,0,0
21W.770,21W.770,,8,0,8,2
20.930,20.930,,0,0,0,0
7.932,7.932,,8,0,8,2
7.933,7.933,,8,0,8,2
7.934,7.934,,8,0,8,2
7.935,7.935,,8,0,8,2
7.941,7.941,,8,0,8,2
7.942,7.942,,8,0,8,2
7.MTHG,7.MTHG,,8,0,8,2
7.S392,7.S392,,8,0,8,2
2.URG,2.URG,,0,0,0,0
7.S930,7.S930,,8,0,8,2
7.S932,7.S932,,8,0,8,2
7.S939,7.S939,,8,0,8,2
7.UR,7.UR,,0,0,0,0
7.THU,7.THU,,0,0,0,0
7.URG,7.URG,,0,0,0,0
8.011,8.011,,0,0,0,0
8.01L,8.01L,,0,0,0,0
CC.A10,CC.A10,,0,4,4,4
8.021,8.021,,3,0,3,4
6.215,6.215,,5,0,5,0
HST.S14,HST.S14,,0,0,0,0
8.022,8.022,,2,0,2,4
12.473,12.473,,10,0,10,4
21W.771,21W.771,,0,0,0,0
21W.777,21W.777,,0,0,0,0
21W.775,21W.775,,0,0,0,0
21W.778,21W.778,,0,0,0,0
21W.786,21W.786,,0,0,0,0
21W.787,21W.787,,0,0,0,0
21W.788,21W.788,,0,0,0,0
7.85,7.85,,0,1,1,3
21W.790,21W.790,,0,0,0,0
21W.789,21W.789,,11,0,11,0
CMS.614,CMS.614,,0,0,0,0
21W.792,21W.792,,0,0,0,0
21W.798,21W.798,,0,0,0,0
21W.799,21W.799,,0,0,0,0
STS.477,STS.477,,6,0,6,0
21W.823,21W.823,,6,0,6,0
HST.S18,HST.S18,,8,0,8,2
21W.825,21W.825,,8,0,8,2
21W.752,21W.752,,18,0,18,0
21M.803,21M.803,,8,0,8,2
21W.826,21W.826,,14,0,14,0
21W.892,21W.892,,8,0,8,2
8.04,8.04,,3,5,8,4
15.S62,15.S62,,8,0,8,2
21W.S96,21W.S96,,0,0,0,0
21W.THT,21W.THT,,0,0,0,0
8.08,8.08,,2,1,3,4
HST.S46,HST.S46,,0,0,0,0
8.13,8.13,,4,2,6,4
8.18,8.18,,8,0,8,2
8.19,8.19,,0,0,0,0
8.20,8.20,,2,0,2,4
8.21,8.21,,3,0,3,4
21W.022,21W.022,,0,0,0,0
8.224,8.224,,5,0,5,0
21W.032,21W.032,,0,0,0,0
21W.034,21W.034,,0,0,0,0
15.660,15.660,,4,0,4,0
HST.S48,HST.S48,,0,0,0,0
2.744,2.744,,4,0,4,0
21M.806,21M.806,,8,0,8,2
1.036,1.036,,2,1,3,4
HST.S52,HST.S52,,8,0,8,2
CC.5111,CC.5111,,5,0,5,1
15.773,15.773,,8,0,8,2
1.041,1.041,,3,0,3,1
18.784,18.784,,5,0,5,1
2.003,2.003,,0,11,11,4
1.050,1.050,,2,4,6,4
4.440,4.440,,8,1,9,1
1.054,1.054,,5,0,5,0
1.057,1.057,,8,0,8,2
HST.S53,HST.S53,,0,0,0,0
1.058,1.058,,13,0,13,0
1.060A,1.060A,,13,1,14,8
1.060B,1.060B,,5,2,7,0
1.061A,1.061A,,5,2,7,8
HST.S54,HST.S54,,0,0,0,0
21W.035,21W.035,,0,0,0,0
15.073,15.073,,6,0,6,0
AS.412,AS.412,,3,1,4,3
20.315,20.315,,3,0,3,4
2.752,2.752,,14,0,14,0
ES.729,ES.729,,0,0,0,0
1.231,1.231,,8,0,8,2
MAS.377,MAS.377,,0,0,0,0
1.207,1.207,,11,0,11,0
CMS.350,CMS.350,,0,0,0,0
8.276,8.276,,2,0,2,4
1.208,1.208,,3,0,3,1
8.282,8.282,,8,0,8,1
HST.S56,HST.S56,,8,0,8,2
16.71,16.71,,0,0,0,0
8.277,8.277,,3,0,3,3
16.763,16.763,,18,0,18,0
11.526,11.526,,8,0,8,2
8.284,8.284,,2,0,2,4
21W.742,21W.742,,0,0,0,0
12.425,12.425,,2,0,2,4
16.75,16.75,,5,0,5,0
21W.743,21W.743,,0,0,0,0
8.286,8.286,,2,0,2,4
21W.744,21W.744,,0,0,0,0
12.410,12.410,,0,0,0,0
1.254,1.254,,8,0,8,2
21W.746,21W.746,,0,0,0,0
21W.747,21W.747,,0,0,0,0
1.258,1.258,,12,0,12,0
21W.748,21W.748,,8,0,8,2
21W.749,21W.749,,8,0,8,2
21M.223,21M.223,,0,0,0,0
8.295,8.295,,0,0,0,0
1.27,1.27,,8,0,8,2
8.297,8.297,,4,0,4,4
21W.750,21W.750,,0,0,0,0
HST.S58,HST.S58,,8,0,8,2
21W.751,21W.751,,0,0,0,0
8.299,8.299,,0,0,0,0
CMS.314,CMS.314,,0,0,0,0
21W.755,21W.755,,0,0,0,0
CDO.THG,CDO.THG,,8,0,8,2
HST.S59,HST.S59,,8,0,8,2
CDO.IND,CDO.IND,,0,0,0,0
CMS.360,CMS.360,,0,0,0,0
6.556,6.556,,4,0,4,0
CMS.361,CMS.361,,0,0,0,0
CMS.362,CMS.362,,0,0,0,0
CMS.608,CMS.608,,0,0,0,0
CMS.376,CMS.376,,0,0,0,0
CMS.880,CMS.880,,8,0,8,2
CC.512,CC.512,,0,0,0,0
CMS.594,CMS.594,,0,0,0,0
CMS.701,CMS.701,,0,0,0,0
18.369,18.369,,14,0,14,0
20.110,20.110,,3,5,8,4
8.311,8.311,,4,0,4,0
CMS.610,CMS.610,,8,0,8,2
15.764,15.764,,11,0,11,12
15.763,15.763,,8,0,8,0
HST.S79,HST.S79,,8,0,8,2
IDS.305,IDS.305,,8,0,8,2
8.322,8.322,,2,3,5,4
15.762,15.762,,7,0,7,0
CMS.950,CMS.950,,8,0,8,2
CMS.100,CMS.100,,0,0,0,0
CMS.300,CMS.300,,0,0,0,0
2.778,2.778,,8,0,8,2
CMS.301,CMS.301,,0,0,0,0
11.481,11.481,,2,0,2,3
CMS.307,CMS.307,,0,0,0,0
8.333,8.333,,2,2,4,4
8.325,8.325,,5,0,5,0
4.694,4.694,,8,0,8,2
CMS.308,CMS.308,,0,0,0,0
11.482,11.482,,13,0,13,0
6.811,6.811,,8,0,8,2
11.165,11.165,,14,0,14,0
CMS.313,CMS.313,,0,0,0,0
1.331,1.331,,8,0,8,2
ES.333,ES.333,,0,0,0,0
1.351,1.351,,4,0,4,0
8.381,8.381,,8,0,8,2
8.391,8.391,,8,0,8,2
8.382,8.382,,8,0,8,2
1.37,1.37,,5,0,5,0
1.38,1.38,,8,1,9,13
8.399,8.399,,8,0,8,2
8.398,8.398,,8,0,8,2
1.381,1.381,,2,0,2,13
21L.612,21L.612,,13,0,13,0
CMS.338,CMS.338,,12,0,12,2
HST.S98,HST.S98,,8,0,8,2
1.39,1.39,,8,0,8,2
1.383,1.383,,13,0,13,0
11.345,11.345,,8,0,8,2
8.421,8.421,,4,0,4,0
2.782,2.782,,11,0,11,4
11.344,11.344,,8,0,8,2
2.611,2.611,,0,1,1,4
6.S913,6.S913,,8,0,8,2
STS.417,STS.417,,0,0,0,0
6.S914,6.S914,,8,0,8,2
12.809,12.809,,8,0,8,2
4.S14,4.S14,,8,0,8,2
HST.UR,HST.UR,,0,0,0,0
21A.901,21A.901,,0,0,0,0
1.545,1.545,,8,0,8,2
8.482,8.482,,5,0,5,0
8.481,8.481,,5,0,5,0
8.511,8.511,,5,0,5,0
1.562,1.562,,0,0,0,0
1.563,1.563,,0,0,0,0
1.571,1.571,,8,0,8,2
6.S919,6.S919,,8,0,8,2
8.513,8.513,,4,0,4,4
1.57,1.57,,12,1,13,4
CMS.400,CMS.400,,0,0,0,0
15.575,15.575,,8,0,8,2
8.581,8.581,,8,0,8,2
CMS.407,CMS.407,,0,0,0,0
1.570,1.570,,10,0,10,4
1.572,1.572,,8,0,8,2
18.157,18.157,,4,0,4,0
8.514,8.514,,2,0,2,4
CMS.603,CMS.603,,8,0,8,2
4.450,4.450,,8,0,8,2
8.582,8.582,,8,0,8,2
CMS.604,CMS.604,,8,0,8,2
2.080,2.080,,3,0,3,0
CMS.605,CMS.605,,0,0,0,0
1.589,1.589,,8,0,8,2
18.702,18.702,,5,1,6,0
CMS.606,CMS.606,,0,0,0,0
12.811,12.811,,7,0,7,0
1.66,1.66,,8,0,8,2
8.592,8.592,,11,0,11,0
2.26,2.26,,3,0,3,4
8.593,8.593,,0,0,0,0
1.631,1.631,,0,0,0,0
22.611,22.611,,4,0,4,4
18.158,18.158,,5,0,5,0
12.480,12.480,,6,0,6,0
1.67,1.67,,4,0,4,0
8.614,8.614,,5,0,5,0
CMS.951,CMS.951,,7,0,7,0
8.641,8.641,,6,0,6,0
CMS.990,CMS.990,,0,0,0,0
CMS.993,CMS.993,,8,0,8,2
2.24,2.24,,2,0,2,4
8.681,8.681,,6,0,6,0
20.305,20.305,,0,0,0,0
8.682,8.682,,6,0,6,0
8.711,8.711,,2,0,2,0
CMS.S60,CMS.S60,,8,0,8,2
CMS.S61,CMS.S61,,8,0,8,2
6.S966,6.S966,,0,0,0,0
6.S967,6.S967,,0,0,0,0
CMS.S98,CMS.S98,,8,0,8,2
18.176,18.176,,5,0,5,0
1.77,1.77,,5,0,5,0
6.S974,6.S974,,0,0,0,0
CMS.THG,CMS.THG,,11,0,11,2
8.841,8.841,,5,0,5,0
8.861,8.861,,5,0,5,0
21L.703,21L.703,,0,0,0,0
CMS.URG,CMS.URG,,0,0,0,0
8.882,8.882,,3,0,3,0
CMS.615,CMS.615,,0,0,0,0
8.913,8.913,,8,0,8,2
8.921,8.921,,8,0,8,2
8.902,8.902,,5,0,5,0
10.65,10.65,,13,0,13,0
8.942,8.942,,8,0,8,2
CMS.617,CMS.617,,8,0,8,0
1.851,1.851,,0,0,0,0
18.177,18.177,,5,0,5,0
21M.030,21M.030,,0,0,0,0
6.THG,6.THG,,8,0,8,2
18.199,18.199,,8,0,8,2
21M.065,21M.065,,0,0,0,0
6.THM,6.THM,,5,0,5,1
2.04B,2.04B,,0,1,1,4
21M.220,21M.220,,6,0,6,0
CMS.627,CMS.627,,8,0,8,2
1.871,1.871,,0,0,0,0
6.URS,6.URS,,8,0,8,2
1.S977,1.S977,,8,0,8,2
6.UAR,6.UAR,,2,0,2,3
1.982,1.982,,0,0,0,0
7.012,7.012,,0,0,0,0
2.EPE,2.EPE,,11,0,11,2
6.542,6.542,,8,0,8,2
2.EPW,2.EPW,,0,0,0,0
6.UAT,6.UAT,,0,0,0,0
2.28,2.28,,6,0,6,4
1.S980,1.S980,,8,0,8,2
21M.226,21M.226,,0,0,0,0
1.S993,1.S993,,8,0,8,2
1.THU,1.THU,,8,0,8,2
18.204,18.204,,13,0,13,1
1.UR,1.UR,,0,0,0,0
7.013,7.013,,0,0,0,0
1.URG,1.URG,,0,0,0,0
2.00,2.00,,0,0,0,0
HST.714,HST.714,,10,0,10,4
CC.1803,CC.1803,,4,0,4,4
10.80,10.80,,0,0,0,0
18.354,18.354,,3,0,3,4
10.301,10.301,,2,10,12,3
14.20,14.20,,4,0,4,0
10.81,10.81,,0,0,0,0
2.002,2.002,,2,2,4,4
2.004,2.004,,2,6,8,4
9.073,9.073,,8,0,8,2
21L.613,21L.613,,13,0,13,0
9.04,9.04,,12,0,12,0
10.807,10.807,,12,0,12,0
9.07,9.07,,3,2,5,3
2.005,2.005,,13,12,25,4
9.10,9.10,,4,1,5,0
2.006,2.006,,6,5,11,4
18.218,18.218,,8,0,8,2
9.11,9.11,,4,0,4,0
2.007,2.007,,3,1,4,4
9.123,9.123,,8,0,8,2
2.008,2.008,,4,2,6,4
18.212,18.212,,6,0,6,0
9.12,9.12,,2,0,2,3
9.15,9.15,,14,0,14,0
CC.011,CC.011,,0,4,4,4
CC.010,CC.010,,8,4,12,4
CC.110,CC.110,,5,0,5,1
9.16,9.16,,4,0,4,0
CC.S10,CC.S10,,8,0,8,2
2.00A,2.00A,,2,0,2,4
CC.S21,CC.S21,,0,0,0,0
2.00B,2.00B,,0,3,3,4
9.17,9.17,,4,0,4,3
10.83,10.83,,0,0,0,0
CC.116,CC.116,,0,0,0,0
2.013,2.013,,15,0,15,4
4.692,4.692,,8,0,8,2
HST.URG,HST.URG,,0,0,0,0
3.931,3.931,,4,0,4,0
CC.181A,CC.181A,,0,0,0,0
2.370,2.370,,8,1,9,2
15.799,15.799,,0,0,0,0
6.021,6.021,,8,1,9,4
21L.614,21L.614,,14,0,14,0
HST.192,HST.192,,8,0,8,2
CSB.199,CSB.199,,8,0,8,2
CSB.110,CSB.110,,8,0,8,2
CSB.THG,CSB.THG,,8,0,8,2
2.019,2.019,,4,0,4,4
2.032,2.032,,4,0,4,0
2.02A,2.02A,,4,0,4,0
20.330,20.330,,5,1,6,4
20.430,20.430,,8,0,8,2
16.413,16.413,,0,1,1,1
15.822,15.822,,0,0,0,0
12.006,12.006,,3,0,3,4
2.051,2.051,,4,12,16,4
9.357,9.357,,8,0,8,2
21G.418,21G.418,,0,2,2,3
1.079,1.079,,14,0,14,4
6.S198,6.S198,,8,0,8,2
9.40,9.40,,11,3,14,3
9.41,9.41,,2,0,2,3
20.352,20.352,,8,0,8,2
MAS.883,MAS.883,,8,0,8,2
HST.199,HST.199,,8,0,8,2
HST.198,HST.198,,8,0,8,2
24.08,24.08,,0,0,0,0
1.080B,1.080B,,5,0,5,0
9.50,9.50,,2,0,2,3
9.56,9.56,,13,0,13,0
15.834,15.834,,0,0,0,0
2.065,2.065,,7,0,7,0
6.S897,6.S897,,8,0,8,2
ES.801,ES.801,,0,0,0,0
AS.112,AS.112,,3,2,5,3
ES.8012,ES.8012,,0,0,0,0
ES.802,ES.802,,2,0,2,4
ES.8022,ES.8022,,2,0,2,4
10.01,10.01,,0,1,1,3
ES.S10,ES.S10,,0,0,0,0
4.S48,4.S48,,8,0,8,2
20.219,20.219,,8,0,8,2
15.835,15.835,,0,0,0,0
ES.S20,ES.S20,,0,0,0,0
ES.S21,ES.S21,,0,0,0,0
ES.S30,ES.S30,,0,0,0,0
20.106,20.106,,2,0,2,4
2.072,2.072,,5,0,5,0
ES.S40,ES.S40,,0,0,0,0
2.074,2.074,,2,0,2,4
15.838,15.838,,0,0,0,0
ES.S41,ES.S41,,0,0,0,0
ES.S42,ES.S42,,0,0,0,0
4.S53,4.S53,,8,0,8,2
16.223,16.223,,14,0,14,0
ES.S51,ES.S51,,0,0,0,0
15.839,15.839,,8,0,8,2
2.081,2.081,,14,1,15,4
ES.S61,ES.S61,,0,0,0,0
1.087,1.087,,5,0,5,0
2.082,2.082,,2,1,3,4
ES.S71,ES.S71,,0,0,0,0
ES.UR,ES.UR,,0,0,0,0
6.S898,6.S898,,8,0,8,2
2.086,2.086,,4,4,8,4
ES.010,ES.010,,0,0,0,0
1.089,1.089,,7,0,7,1
2.087,2.087,,2,9,11,4
20.310,20.310,,5,0,5,4
9.601,9.601,,8,0,8,2
4.S54,4.S54,,8,0,8,2
9.59,9.59,,5,0,5,0
9.65,9.65,,3,1,4,0
8.422,8.422,,4,0,4,0
16.920,16.920,,6,1,7,0
4.S56,4.S56,,8,0,8,2
18.435,18.435,,8,1,9,1
4.S62,4.S62,,8,0,8,2
20.410,20.410,,6,0,6,4
EC.770,EC.770,,8,0,8,2
15.843,15.843,,5,0,5,0
4.S46,4.S46,,8,0,8,2
9.S911,9.S911,,8,0,8,2
HST.041,HST.041,,3,0,3,4
AS.212,AS.212,,3,2,5,3
4.S61,4.S61,,0,0,0,0
HST.061,HST.061,,3,0,3,4
HST.071,HST.071,,2,0,2,4
HST.081,HST.081,,4,0,4,0
20.260,20.260,,8,0,8,2
CSB.190,CSB.190,,8,0,8,2
HST.091,HST.091,,7,0,7,0
4.S66,4.S66,,8,0,8,2
HST.101,HST.101,,2,0,2,4
4.S67,4.S67,,8,0,8,2
HST.111,HST.111,,12,0,12,0
4.S68,4.S68,,8,0,8,2
HST.121,HST.121,,2,0,2,4
HST.131,HST.131,,8,0,8,2
EC.724,EC.724,,0,0,0,0
9.S915,9.S915,,8,0,8,2
2.151,2.151,,4,0,4,4
9.S917,9.S917,,8,0,8,2
2.152,2.152,,15,0,15,0
9.S913,9.S913,,8,0,8,2
9.S914,9.S914,,8,0,8,2
2.154,2.154,,2,0,2,0
2.153,2.153,,4,0,4,0
2.160,2.160,,4,0,4,0
9.S93,9.S93,,0,0,0,0
9.S92,9.S92,,3,0,3,0
9.THG,9.THG,,8,0,8,2
9.S94,9.S94,,0,0,0,0
2.165,2.165,,12,0,12,0
6.S912,6.S912,,8,0,8,2
9.S95,9.S95,,0,0,0,0
9.S96,9.S96,,0,0,0,0
2.166,2.166,,14,0,14,0
9.S97,9.S97,,0,0,0,0
2.167,2.167,,0,0,0,0
9.S98,9.S98,,0,0,0,0
2.171,2.171,,13,0,13,0
9.S99,9.S99,,0,0,0,0
9.UR,9.UR,,0,0,0,0
2.180,2.180,,17,0,17,1
9.URG,9.URG,,0,1,1,3
11.THT,11.THT,,0,0,0,0
21L.702,21L.702,,0,0,0,0
10.00,10.00,,2,0,2,4
10.02,10.02,,0,0,0,0
2.184,2.184,,12,0,12,0
10.04,10.04,,0,0,0,0
10.05,10.05,,0,1,1,3
10.06,10.06,,3,0,3,3
4.UR,4.UR,,8,0,8,2
10.10,10.10,,3,2,5,4
2.22,2.22,,3,0,3,0
EC.788,EC.788,,8,0,8,2
10.213,10.213,,2,5,7,4
10.22,10.22,,2,0,2,4
21M.293,21M.293,,0,0,0,0
21M.289,21M.289,,0,0,0,0
HST.147,HST.147,,8,0,8,2
5.73,5.73,,3,0,3,4
18.306,18.306,,5,0,5,4
HST.211,HST.211,,8,0,8,2
21H.141,21H.141,,0,0,0,0
HST.220,HST.220,,8,0,8,2
IDS.412,IDS.412,,0,1,1,3
HST.212,HST.212,,6,0,6,0
15.900,15.900,,0,1,1,3
10.25,10.25,,3,0,3,4
2.25,2.25,,4,3,7,4
15.879,15.879,,2,0,2,3
HST.426,HST.426,,0,0,0,0
12.950,12.950,,8,0,8,2
10.26,10.26,,16,0,16,4
2.29,2.29,,6,0,6,4
HST.500,HST.500,,0,0,0,0
6.S915,6.S915,,8,0,8,2
21M.303,21M.303,,6,0,6,0
17.051,17.051,,0,0,0,0
21M.302,21M.302,,13,0,13,0
15.903,15.903,,5,0,5,0
15.905,15.905,,0,0,0,0
6.S916,6.S916,,8,0,8,2
21L.640,21L.640,,0,0,0,0
4.500,4.500,,0,1,1,1
5.74,5.74,,4,0,4,0
2.51,2.51,,14,2,16,3
2.55,2.55,,4,0,4,0
2.52,2.52,,4,0,4,0
2.570,2.570,,13,0,13,0
HST.527,HST.527,,8,0,8,2
12.812,12.812,,14,0,14,0
22.313,22.313,,14,0,14,0
HST.531,HST.531,,0,0,0,0
6.S917,6.S917,,8,0,8,2
HST.533,HST.533,,5,0,5,0
HST.535,HST.535,,11,0,11,4
2.60,2.60,,14,0,14,4
12.971,12.971,,8,0,8,2
2.61,2.61,,4,0,4,0
2.603,2.603,,4,0,4,0
2.612,2.612,,4,0,4,0
STS.047,STS.047,,0,0,0,0
2.627,2.627,,8,0,8,2
12.980,12.980,,8,0,8,2
2.625,2.625,,18,0,18,0
HST.545,HST.545,,2,0,2,1
17.907,17.907,,0,0,0,0
21M.342,21M.342,,8,0,8,2
21A.01,21A.01,,0,0,0,0
EC.S07,EC.S07,,0,0,0,0
6.S918,6.S918,,8,0,8,2
12.982,12.982,,8,0,8,2
10.426,10.426,,13,0,13,0
EC.S08,EC.S08,,0,0,0,0
12.983,12.983,,8,0,8,2
10.643,10.643,,12,0,12,0
21M.355,21M.355,,8,0,8,2
12.IND,12.IND,,6,0,6,0
10.490,10.490,,5,0,5,0
18.338,18.338,,13,0,13,0
10.491,10.491,,5,0,5,0
21M.351,21M.351,,14,0,14,0
2.64,2.64,,2,0,2,3
EC.S11,EC.S11,,0,0,0,0
EC.711,EC.711,,0,0,0,0
HST.565,HST.565,,0,0,0,0
2.670,2.670,,0,4,4,4
HST.563,HST.563,,10,0,10,4
2.671,2.671,,4,4,8,4
10.973,10.973,,8,0,8,2
2.813,2.813,,12,0,12,0
20.309,20.309,,12,2,14,4
2.674,2.674,,13,0,13,1
2.676,2.676,,3,0,3,4
2.830,2.830,,9,0,9,0
2.678,2.678,,8,3,11,1
HST.590,HST.590,,0,0,0,0
HST.598,HST.598,,0,0,0,0
HST.599,HST.599,,8,0,8,2
HST.011,HST.011,,8,0,8,2
6.S977,6.S977,,8,0,8,2
2.683,2.683,,5,0,5,0
MAS.750,MAS.750,,8,0,8,2
4.S26,4.S26,,8,0,8,2
10.976,10.976,,8,0,8,2
2.687,2.687,,2,1,3,1
10.492,10.492,,2,0,2,3
21M.380,21M.380,,8,0,8,2
2.688,2.688,,2,0,2,4
10.493,10.493,,2,0,2,3
10.494,10.494,,2,0,2,3
10.50,10.50,,2,0,2,3
2.700,2.700,,3,0,3,0
2.70,2.70,,4,0,4,0
10.495,10.495,,12,0,12,0
10.977,10.977,,8,0,8,2
12.S493,12.S493,,8,0,8,2
ES.112,ES.112,,0,0,0,0
2.702,2.702,,5,1,6,0
2.703,2.703,,4,0,4,4
21M.362,21M.362,,13,0,13,0
11.205,11.205,,0,1,1,3
2.705,2.705,,5,0,5,0
2.704,2.704,,5,0,5,0
12.S590,12.S590,,8,0,8,2
2.707,2.707,,4,0,4,0
2.708,2.708,,0,0,0,0
2.71,2.71,,6,0,6,4
2.715,2.715,,8,0,8,2
12.S591,12.S591,,8,0,8,2
20.420,20.420,,2,1,3,4
2.717,2.717,,13,0,13,0
10.540,10.540,,16,0,16,0
10.983,10.983,,8,0,8,2
21M.401,21M.401,,0,0,0,0
10.984,10.984,,8,0,8,2
16.540,16.540,,11,0,11,0
HST.721,HST.721,,8,0,8,2
2.888,2.888,,0,0,0,0
10.552,10.552,,0,0,0,0
10.985,10.985,,8,0,8,2
HST.725,HST.725,,14,0,14,1
5.90,5.90,,8,0,8,2
6.S964,6.S964,,0,0,0,0
5.067,5.067,,14,0,14,0
6.907,6.907,,0,0,0,0
STS.056,STS.056,,0,0,0,0
10.407,10.407,,0,0,0,0
HST.562,HST.562,,0,0,0,0
10.992,10.992,,8,0,8,2
MAS.535,MAS.535,,0,0,0,0
6.902,6.902,,0,0,0,0
10.994,10.994,,8,0,8,2
7.29,7.29,,6,1,7,0
HST.953,HST.953,,8,0,8,2
EC.720,EC.720,,0,0,0,0
21M.215,21M.215,,8,0,8,2
EC.729,EC.729,,8,0,8,2
12.306,12.306,,11,0,11,4
2.994,2.994,,0,0,0,0
10.580,10.580,,5,0,5,0
10.585,10.585,,13,0,13,0
17.S912,17.S912,,0,0,0,0
HST.956,HST.956,,10,0,10,0
10.995,10.995,,8,0,8,2
10.591,10.591,,12,0,12,2
ES.1802,ES.1802,,8,0,8,1
10.606,10.606,,0,0,0,0
HST.980,HST.980,,0,0,0,0
10.997,10.997,,8,0,8,2
HST.S15,HST.S15,,0,0,0,0
2.737,2.737,,4,0,4,4
10.631,10.631,,4,0,4,0
15.783,15.783,,17,0,17,0
HST.S17,HST.S17,,0,0,0,0
2.995,2.995,,8,0,8,2
SCM.265,SCM.265,,16,0,16,0
IDS.411,IDS.411,,2,0,2,3
HST.S19,HST.S19,,8,0,8,2
7.31,7.31,,12,0,12,0
10.998,10.998,,0,0,0,0
HST.S49,HST.S49,,0,0,0,0
20.020,20.020,,0,1,1,3
10.S94,10.S94,,8,0,8,2
HST.S55,HST.S55,,0,0,0,0
10.S95,10.S95,,8,0,8,2
HST.S76,HST.S76,,8,0,8,2
2.760,2.760,,12,0,12,0
HST.S77,HST.S77,,8,0,8,2
HST.S78,HST.S78,,8,0,8,2
HST.S96,HST.S96,,8,0,8,2
HST.S97,HST.S97,,8,0,8,2
ES.1803,ES.1803,,8,0,8,1
HST.S99,HST.S99,,8,0,8,2
HST.THG,HST.THG,,8,0,8,2
11.229,11.229,,0,0,0,0
5.13,5.13,,4,6,10,4
10.644,10.644,,12,0,12,0
10.677,10.677,,12,0,12,0
5.301,5.301,,2,0,2,4
4.S40,4.S40,,0,0,0,0
7.341,7.341,,6,0,6,0
6.022,6.022,,18,0,18,1
IDS.522,IDS.522,,8,0,8,2
HST.194,HST.194,,7,0,7,0
HST.196,HST.196,,0,0,0,0
6.S975,6.S975,,0,0,0,0
18.655,18.655,,8,0,8,2
17.925,17.925,,0,0,0,0
2.799,2.799,,7,0,7,0
2.810,2.810,,3,0,3,4
3.371,3.371,,8,0,8,2
10.85,10.85,,0,0,0,0
10.86,10.86,,0,0,0,0
10.87,10.87,,0,0,0,0
10.90,10.90,,8,0,8,2
12.S592,12.S592,,8,0,8,2
21A.501,21A.501,,0,0,0,0
10.910,10.910,,0,0,0,0
10.911,10.911,,0,0,0,0
10.953,10.953,,0,0,0,0
10.954,10.954,,8,0,8,2
10.955,10.955,,8,0,8,2
10.956,10.956,,8,0,8,2
10.957,10.957,,8,0,8,2
10.958,10.958,,8,0,8,2
10.961,10.961,,8,0,8,2
4.504,4.504,,4,0,4,0
10.962,10.962,,8,0,8,2
10.964,10.964,,8,0,8,2
10.965,10.965,,8,0,8,2
10.966,10.966,,8,0,8,2
7.345,7.345,,6,0,6,0
10.967,10.967,,8,0,8,2
10.968,10.968,,8,0,8,2
10.969,10.969,,8,0,8,2
10.970,10.970,,8,0,8,2
7.S391,7.S391,,8,0,8,2
10.971,10.971,,8,0,8,2
10.974,10.974,,8,0,8,2
6.S979,6.S979,,8,0,8,2
15.066,15.066,,8,0,8,1
10.975,10.975,,8,0,8,2
EC.305,EC.305,,0,0,0,0
7.346,7.346,,6,0,6,0
11.469,11.469,,8,0,8,2
10.978,10.978,,8,0,8,2
10.981,10.981,,8,0,8,2
10.982,10.982,,8,0,8,2
12.S990,12.S990,,8,0,8,2
10.987,10.987,,8,0,8,2
7.347,7.347,,6,0,6,0
10.991,10.991,,8,0,8,2
2.96,2.96,,0,0,0,0
12.S991,12.S991,,8,0,8,2
2.961,2.961,,0,0,0,0
IDS.410,IDS.410,,0,0,0,0
11.236,11.236,,0,0,0,0
7.348,7.348,,6,0,6,0
12.S992,12.S992,,8,0,8,2
18.657,18.657,,8,0,8,2
IDS.521,IDS.521,,8,0,8,2
21M.235,21M.235,,13,0,13,0
12.800,12.800,,0,1,1,0
12.S993,12.S993,,8,0,8,2
15.S02,15.S02,,8,0,8,2
12.THG,12.THG,,8,0,8,2
5.THU,5.THU,,8,0,8,2
1.097,1.097,,0,0,0,0
IDS.951,IDS.951,,0,0,0,0
12.TIP,12.TIP,,0,0,0,0
1.092,1.092,,4,0,4,0
10.URG,10.URG,,0,0,0,0
12.URG,12.URG,,0,0,0,0
11.003,11.003,,2,0,2,3
15.S07,15.S07,,8,0,8,2
2.S97,2.S97,,0,0,0,0
12.UR,12.UR,,0,0,0,0
1.102,1.102,,13,0,13,1
7.371,7.371,,4,0,4,0
2.S982,2.S982,,8,0,8,2
2.S992,2.S992,,0,0,0,0
17.956,17.956,,8,0,8,2
2.S995,2.S995,,0,0,0,0
2.S998,2.S998,,8,0,8,2
2.009,2.009,,7,0,7,4
21H.321,21H.321,,0,0,0,0
21M.490,21M.490,,8,0,8,2
10.28,10.28,,12,0,12,4
2.THU,2.THU,,0,0,0,0
2.THG,2.THG,,11,0,11,2
3.35,3.35,,11,0,11,0
14.01,14.01,,0,13,13,3
21G.716J,21G.716J,,0,1,1,3
IDS.961,IDS.961,,0,0,0,0
11.124,11.124,,0,0,0,0
21G.738J,21G.738J,,0,1,1,3
IDS.971,IDS.971,,0,0,0,0
21G.740J,21G.740J,,0,1,1,3
IDS.S00,IDS.S00,,8,0,8,2
2.996,2.996,,8,0,8,2
7.394,7.394,,0,0,0,0
IDS.S10,IDS.S10,,8,0,8,2
2.701,2.701,,0,1,1,4
14.03,14.03,,12,1,13,3
IDS.S20,IDS.S20,,8,0,8,2
2.997,2.997,,8,0,8,2
IDS.S21,IDS.S21,,8,0,8,2
7.395,7.395,,0,0,0,0
IDS.S22,IDS.S22,,8,0,8,2
18.700,18.700,,8,14,22,1
14.02,14.02,,0,5,5,3
11.146,11.146,,0,0,0,0
IDS.S24,IDS.S24,,8,0,8,2
2.998,2.998,,8,0,8,2
IDS.S30,IDS.S30,,0,0,0,0
7.396,7.396,,0,0,0,0
11.148,11.148,,0,0,0,0
21H.220,21H.220,,0,0,0,0
IDS.S32,IDS.S32,,0,0,0,0
9.24,9.24,,3,0,3,3
STS.080,STS.080,,0,0,0,0
2.999,2.999,,8,0,8,2
21H.385,21H.385,,0,0,0,0
IDS.UR,IDS.UR,,0,0,0,0
11.156,11.156,,0,0,0,0
11.159,11.159,,0,0,0,0
10.UR,10.UR,,0,0,0,0
9.272,9.272,,8,0,8,2
2.S791,2.S791,,8,0,8,2
6.840,6.840,,0,2,2,1
17.957,17.957,,8,0,8,2
3.001,3.001,,0,0,0,0
3.004,3.004,,2,0,2,4
7.430,7.430,,8,0,8,2
2.S790,2.S790,,8,0,8,2
3.005,3.005,,0,0,0,0
3.012,3.012,,7,5,12,14
3.016,3.016,,8,4,12,1
7.431,7.431,,8,0,8,2
3.014,3.014,,0,4,4,14
15.S15,15.S15,,8,0,8,2
7.432,7.432,,8,0,8,2
18.408,18.408,,8,0,8,2
14.04,14.04,,2,6,8,3
3.024,3.024,,5,5,10,14
2.S007,2.S007,,0,0,0,0
3.034,3.034,,5,1,6,0
3.035,3.035,,8,0,8,2
2.S670,2.S670,,0,0,0,0
3.037,3.037,,8,0,8,2
21M.533,21M.533,,8,0,8,2
3.038,3.038,,8,0,8,2
11.237,11.237,,13,0,13,0
7.435,7.435,,8,0,8,2
2.S792,2.S792,,8,0,8,2
2.S980,2.S980,,8,0,8,2
17.958,17.958,,8,0,8,2
7.437,7.437,,8,0,8,2
2.S981,2.S981,,8,0,8,2
15.094,15.094,,13,0,13,0
1.151,1.151,,8,1,9,2
ES.5111,ES.5111,,0,0,0,0
11.005,11.005,,0,0,0,0
2.S972,2.S972,,0,0,0,0
15.S21,15.S21,,8,0,8,2
11.233,11.233,,8,1,9,3
11.006,11.006,,0,0,0,0
18.0851,18.0851,,0,1,1,1
MAS.132,MAS.132,,8,0,8,2
7.45,7.45,,4,0,4,0
2.S973,2.S973,,0,0,0,0
MAS.UR,MAS.UR,,0,0,0,0
11.238,11.238,,8,0,8,2
MAS.URG,MAS.URG,,0,0,0,0
3.044,3.044,,2,3,5,14
11.011,11.011,,0,0,0,0
MAS.490,MAS.490,,8,0,8,2
MAS.491,MAS.491,,8,0,8,2
3.046,3.046,,13,0,13,0
3.048,3.048,,2,0,2,14
11.250,11.250,,8,0,8,2
1.201,1.201,,8,0,8,2
2.S975,2.S975,,0,0,0,0
3.052,3.052,,12,0,12,0
11.255,11.255,,0,0,0,0
1.200,1.200,,2,0,2,1
MAS.533,MAS.533,,8,0,8,2
11.013,11.013,,0,0,0,0
11.260,11.260,,0,0,0,0
15.219,15.219,,0,0,0,0
20.363,20.363,,14,0,14,0
3.054,3.054,,4,0,4,0
17.959,17.959,,8,0,8,2
MAS.581,MAS.581,,0,0,0,0
MAS.600,MAS.600,,8,0,8,2
15.S24,15.S24,,8,0,8,2
3.064,3.064,,2,0,2,14
3.063,3.063,,5,0,5,0
11.014,11.014,,0,0,0,0
MAS.630,MAS.630,,8,0,8,2
ES.5112,ES.5112,,0,0,0,0
3.071,3.071,,5,0,5,0
3.07,3.07,,5,0,5,0
2.S996,2.S996,,8,0,8,2
24.635,24.635,,8,0,8,2
11.313,11.313,,8,0,8,2
18.418,18.418,,15,0,15,0
3.080,3.080,,14,0,14,0
3.074,3.074,,5,0,5,0
MAS.712,MAS.712,,8,0,8,2
11.318,11.318,,8,0,8,2
2.S997,2.S997,,8,0,8,2
MAS.756,MAS.756,,8,0,8,2
11.320,11.320,,8,0,8,2
3.086,3.086,,0,0,0,0
2.S990,2.S990,,0,0,0,0
3.091,3.091,,0,0,0,0
3.094,3.094,,0,0,0,0
3.095,3.095,,0,0,0,0
3.14,3.14,,2,0,2,14
3.152,3.152,,5,0,5,0
2.S991,2.S991,,0,0,0,0
3.15,3.15,,5,0,5,0
3.153,3.153,,5,0,5,0
3.154,3.154,,2,0,2,14
6.152,6.152,,16,0,16,1
24.01,24.01,,0,0,0,0
3.156,3.156,,3,0,3,14
15.794,15.794,,8,0,8,2
3.171,3.171,,2,0,2,14
2.S993,2.S993,,0,0,0,0
3.18,3.18,,2,0,2,14
17.960,17.960,,8,0,8,2
3.19,3.19,,4,0,4,0
2.S994,2.S994,,0,0,0,0
EC.701,EC.701,,0,0,0,0
3.20,3.20,,14,2,16,14
ES.7012,ES.7012,,0,0,0,0
3.21,3.21,,14,3,17,14
6.0001,6.0001,,0,4,4,4
15.784,15.784,,5,0,5,0
22.033,22.033,,0,0,0,0
MAS.771,MAS.771,,8,0,8,2
MAS.790,MAS.790,,8,0,8,2
18.424,18.424,,6,0,6,1
20.334,20.334,,12,0,12,0
MAS.808,MAS.808,,8,0,8,2
2.S999,2.S999,,8,0,8,2
MAS.834,MAS.834,,8,0,8,2
MAS.836,MAS.836,,8,0,8,2
11.338,11.338,,5,0,5,0
20.104,20.104,,3,0,3,4
11.027,11.027,,8,0,8,2
MAS.864,MAS.864,,8,0,8,2
11.351,11.351,,0,0,0,0
MAS.865,MAS.865,,7,0,7,0
MAS.890,MAS.890,,8,0,8,2
11.354,11.354,,0,0,0,0
MAS.910,MAS.910,,8,0,8,2
11.111,11.111,,11,0,11,0
MAS.912,MAS.912,,0,0,0,0
2.UR,2.UR,,0,0,0,0
18.217,18.217,,8,0,8,2
MAS.915,MAS.915,,8,0,8,2
11.360,11.360,,8,0,8,2
MAS.921,MAS.921,,8,0,8,2
11.123,11.123,,0,0,0,0
11.364,11.364,,14,0,14,0
11.367,11.367,,8,0,8,2
17.962,17.962,,8,0,8,2
MAS.S60,MAS.S60,,8,0,8,2
ES.7013,ES.7013,,0,0,0,0
18.703,18.703,,8,2,10,1
MAS.S62,MAS.S62,,8,0,8,2
MAS.S63,MAS.S63,,8,0,8,2
MAS.S64,MAS.S64,,8,0,8,2
MAS.S65,MAS.S65,,8,0,8,2
9.28,9.28,,4,0,4,0
MAS.S68,MAS.S68,,8,0,8,2
MAS.S69,MAS.S69,,8,0,8,2
MAS.S70,MAS.S70,,8,0,8,2
MAS.S71,MAS.S71,,8,0,8,2
RED.THG,RED.THG,,8,0,8,2
SP.120,SP.120,,2,0,2,5
3.38,3.38,,0,0,0,0
SP.100,SP.100,,0,0,0,0
SP.110,SP.110,,2,0,2,5
Master Subject,Master Subject,,12,0,12,2
SCM.250,SCM.250,,0,0,0,0
15.S58,15.S58,,8,0,8,2
SCM.252,SCM.252,,0,0,0,0
6.720,6.720,,7,0,7,0
SCM.253,SCM.253,,7,0,7,0
SCM.259,SCM.259,,0,0,0,0
15.785,15.785,,0,0,0,0
11.377,11.377,,8,0,8,2
11.380,11.380,,8,0,8,2
11.382,11.382,,8,0,8,2
6.002,6.002,,3,3,6,4
1.007,1.007,,0,0,0,0
11.381,11.381,,11,0,11,3
HST.176,HST.176,,4,0,4,0
1.013,1.013,,8,0,8,2
HST.S57,HST.S57,,8,0,8,2
11.401,11.401,,0,1,1,3
1.011,1.011,,0,1,1,4
IDS.S11,IDS.S11,,0,0,0,0
11.404,11.404,,0,0,0,0
6.552,6.552,,11,0,11,4
11.142,11.142,,0,0,0,0
11.433,11.433,,5,0,5,0
3.65,3.65,,8,0,8,2
11.434,11.434,,0,0,0,0
3.69,3.69,,0,0,0,0
11.436,11.436,,6,0,6,0
SCM.270,SCM.270,,0,0,0,0
3.697,3.697,,0,0,0,0
3.698,3.698,,0,0,0,0
3.699,3.699,,0,0,0,0
IDS.S23,IDS.S23,,8,0,8,2
SCM.290,SCM.290,,0,0,0,0
SCM.301,SCM.301,,0,0,0,0
2.017,2.017,,6,1,7,4
SCM.302,SCM.302,,0,0,0,0
11.457,11.457,,0,0,0,0
20.416,20.416,,0,0,0,0
SCM.S90,SCM.S90,,0,0,0,0
10.668,10.668,,14,0,14,0
3.94,3.94,,4,0,4,0
11.147,11.147,,8,0,8,2
1.018A,1.018A,,0,1,1,1
14.09,14.09,,2,0,2,3
18.705,18.705,,6,0,6,0
1.020,1.020,,4,0,4,4
5.54,5.54,,4,0,4,4
SCM.S92,SCM.S92,,0,0,0,0
2.341,2.341,,14,0,14,0
HST.191,HST.191,,8,0,8,1
11.470,11.470,,8,0,8,2
SCM.251,SCM.251,,13,0,13,2
STS.THU,STS.THU,,4,0,4,1
EC.715,EC.715,,0,0,0,0
STS.UR,STS.UR,,0,0,0,0
STS.001,STS.001,,0,0,0,0
3.982,3.982,,0,0,0,0
21H.351,21H.351,,0,0,0,0
3.983,3.983,,0,0,0,0
11.475,11.475,,0,0,0,0
3.984,3.984,,8,0,8,2
3.981,3.981,,0,0,0,0
3.989,3.989,,8,0,8,2
STS.003,STS.003,,0,0,0,0
3.985,3.985,,11,1,12,1
STS.004,STS.004,,0,0,0,0
IDS.URG,IDS.URG,,0,0,0,0
3.986,3.986,,0,1,1,1
3.987,3.987,,0,0,0,0
STS.007,STS.007,,0,0,0,0
3.990,3.990,,3,0,3,1
3.997,3.997,,8,0,8,2
STS.008,STS.008,,0,0,0,0
STS.009,STS.009,,0,0,0,0
3.993,3.993,,0,0,0,0
STS.011,STS.011,,0,0,0,0
15.S31,15.S31,,0,0,0,0
STS.012,STS.012,,0,0,0,0
3.S01,3.S01,,8,0,8,2
WGS.226,WGS.226,,0,0,0,0
11.158,11.158,,0,0,0,0
3.S03,3.S03,,8,0,8,2
11.490,11.490,,8,0,8,2
3.S05,3.S05,,8,0,8,2
STS.026,STS.026,,0,0,0,0
11.491,11.491,,4,0,4,0
3.S07,3.S07,,8,0,8,2
11.493,11.493,,0,0,0,0
3.S08,3.S08,,8,0,8,2
STS.028,STS.028,,0,0,0,0
3.S09,3.S09,,8,0,8,2
STS.032,STS.032,,0,0,0,0
3.S71,3.S71,,8,0,8,2
3.S72,3.S72,,8,0,8,2
STS.034,STS.034,,0,0,0,0
3.S74,3.S74,,8,0,8,2
STS.035,STS.035,,0,0,0,0
3.S75,3.S75,,8,0,8,2
3.S76,3.S76,,8,0,8,2
21M.645,21M.645,,0,0,0,0
3.S77,3.S77,,8,0,8,2
17.S917,17.S917,,0,0,0,0
STS.043,STS.043,,0,0,0,0
3.S78,3.S78,,8,0,8,2
3.S79,3.S79,,8,0,8,2
3.THG,3.THG,,8,0,8,2
15.031,15.031,,13,0,13,0
3.THU,3.THU,,0,0,0,0
3.UR,3.UR,,0,0,0,0
CC.UR,CC.UR,,8,0,8,2
STS.049,STS.049,,0,0,0,0
4.021,4.021,,0,1,1,1
STS.050,STS.050,,0,0,0,0
4.022,4.022,,0,1,1,1
4.023,4.023,,2,1,3,1
11.162,11.162,,0,0,0,0
12.S593,12.S593,,8,0,8,2
4.024,4.024,,3,1,4,1
4.093,4.093,,8,0,8,2
9.31,9.31,,4,0,4,0
4.025,4.025,,2,0,2,1
4.094,4.094,,8,0,8,2
4.02A,4.02A,,0,0,0,0
4.031,4.031,,0,0,0,0
4.032,4.032,,0,0,0,0
4.091,4.091,,0,0,0,0
21M.700,21M.700,,0,0,0,0
4.092,4.092,,0,0,0,0
4.100,4.100,,0,0,0,0
4.101,4.101,,0,0,0,0
11.499,11.499,,0,0,0,0
7.50,7.50,,3,0,3,3
4.S64,4.S64,,8,0,8,2
10.82,10.82,,0,0,0,0
15.795,15.795,,8,0,8,2
11.527,11.527,,8,0,8,2
2.74,2.74,,12,0,12,0
9.32,9.32,,6,0,6,0
18.453,18.453,,6,0,6,0
11.701,11.701,,0,0,0,0
4.109,4.109,,8,0,8,2
21M.706,21M.706,,0,0,0,0
4.117,4.117,,8,0,8,2
4.110,4.110,,0,0,0,0
10.84,10.84,,0,0,0,0
4.120,4.120,,8,0,8,2
11.800,11.800,,2,1,3,3
21M.705,21M.705,,13,0,13,0
11.903,11.903,,8,0,8,2
4.151,4.151,,8,0,8,2
14.126,14.126,,4,0,4,0
11.904,11.904,,8,0,8,2
4.153,4.153,,5,0,5,0
11.908,11.908,,0,0,0,0
STS.412,STS.412,,0,0,0,0
11.910,11.910,,0,0,0,0
11.920,11.920,,8,0,8,2
15.S45,15.S45,,0,0,0,0
11.961,11.961,,0,0,0,0
11.962,11.962,,8,0,8,2
4.184,4.184,,8,0,8,2
21L.011,21L.011,,0,0,0,0
4.185,4.185,,8,0,8,2
4.190,4.190,,8,0,8,2
4.191,4.191,,8,0,8,2
18.706,18.706,,6,0,6,0
4.192,4.192,,8,0,8,2
4.193,4.193,,8,0,8,2
STS.450,STS.450,,0,0,0,0
STS.454,STS.454,,0,0,0,0
STS.460,STS.460,,0,0,0,0
14.13,14.13,,4,0,4,0
STS.462,STS.462,,0,0,0,0
15.S50,15.S50,,8,0,8,2
17.S950,17.S950,,8,0,8,2
STS.901,STS.901,,8,0,8,2
15.S51,15.S51,,8,0,8,2
STS.800,STS.800,,0,0,0,0
STS.902,STS.902,,8,0,8,2
STS.903,STS.903,,8,0,8,2
STS.904,STS.904,,8,0,8,2
STS.S20,STS.S20,,0,0,0,0
STS.S21,STS.S21,,0,0,0,0
3.017,3.017,,15,0,15,14
STS.S91,STS.S91,,0,0,0,0
STS.S92,STS.S92,,0,0,0,0
18.504,18.504,,8,0,8,1
STS.THG,STS.THG,,8,0,8,2
NS.43,NS.43,,0,0,0,0
NS.42,NS.42,,5,0,5,0
2.750,2.750,,16,0,16,0
15.809,15.809,,0,0,0,0
14.147,14.147,,5,0,5,0
11.S945,11.S945,,8,0,8,2
17.261,17.261,,13,0,13,0
11.333,11.333,,0,0,0,0
11.S952,11.S952,,8,0,8,2
11.337,11.337,,0,0,0,0
3.022,3.022,,5,6,11,14
11.301,11.301,,8,1,9,2
17.S951,17.S951,,8,0,8,2
11.S956,11.S956,,8,0,8,2
NS.100,NS.100,,0,0,0,0
11.334,11.334,,8,0,8,2
3.032,3.032,,3,3,6,14
6.717,6.717,,11,0,11,4
15.S57,15.S57,,8,0,8,2
17.263,17.263,,0,0,0,0
15.810,15.810,,0,0,0,0
15.S59,15.S59,,8,0,8,2
3.036,3.036,,8,0,8,2
14.16,14.16,,12,0,12,0
21M.790,21M.790,,3,0,3,3
18.615,18.615,,7,1,8,0
11.S959,11.S959,,8,0,8,2
WGS.151,WGS.151,,0,0,0,0
11.S965,11.S965,,8,0,8,2
11.S967,11.S967,,8,0,8,2
15.S61,15.S61,,8,0,8,2
18.650,18.650,,7,0,7,0
11.S968,11.S968,,8,0,8,2
11.S969,11.S969,,8,0,8,2
WGS.181,WGS.181,,0,0,0,0
14.19,14.19,,4,0,4,0
11.THG,11.THG,,8,0,8,2
WGS.221,WGS.221,,0,0,0,0
21M.800,21M.800,,0,0,0,0
11.THU,11.THU,,4,0,4,1
3.039,3.039,,8,0,8,2
11.UR,11.UR,,0,0,0,0
WGS.224,WGS.224,,0,0,0,0
11.URG,11.URG,,0,0,0,0
12.000,12.000,,0,0,0,0
WGS.228,WGS.228,,0,0,0,0
3.04,3.04,,8,0,8,2
12.002,12.002,,2,1,3,4
15.S63,15.S63,,8,0,8,2
12.003,12.003,,2,1,3,4
3.042,3.042,,6,1,7,0
16.001,16.001,,4,3,7,4
12.005,12.005,,3,0,3,4
15.812,15.812,,0,0,0,0
12.007,12.007,,0,0,0,0
15.S64,15.S64,,8,0,8,2
WGS.242,WGS.242,,0,0,0,0
NS.12,NS.12,,0,0,0,0
12.010,12.010,,2,1,3,4
11.164,11.164,,8,0,8,2
12.009,12.009,,3,0,3,4
15.S65,15.S65,,8,0,8,2
12.012,12.012,,5,0,5,0
12.021,12.021,,3,0,3,4
17.S953,17.S953,,8,0,8,2
15.S66,15.S66,,8,0,8,2
12.086,12.086,,5,0,5,0
12.091,12.091,,8,0,8,2
12.090,12.090,,8,0,8,2
12.092,12.092,,0,0,0,0
12.093,12.093,,8,0,8,2
11.166,11.166,,8,0,8,2
12.094,12.094,,8,0,8,2
OR.THG,OR.THG,,8,0,8,2
12.095,12.095,,8,0,8,2
21M.809,21M.809,,8,0,8,2
12.096,12.096,,8,0,8,2
12.097,12.097,,8,0,8,2
12.098,12.098,,8,0,8,2
12.099,12.099,,8,0,8,2
12.102,12.102,,0,0,0,0
12.104,12.104,,8,0,8,1
12.108,12.108,,8,0,8,1
14.197,14.197,,0,0,0,0
12.109,12.109,,5,0,5,0
15.818,15.818,,0,0,0,0
15.2191,15.2191,,0,0,0,0
15.S69,15.S69,,8,0,8,2
11.169,11.169,,0,0,0,0
14.198,14.198,,0,0,0,0
15.S70,15.S70,,8,0,8,2
2.42,2.42,,8,0,8,2
21M.830,21M.830,,16,0,16,0
11.188,11.188,,0,0,0,0
15.S71,15.S71,,8,0,8,2
21M.840,21M.840,,0,0,0,0
11.189,11.189,,8,0,8,2
21A.902,21A.902,,0,0,0,0
15.S72,15.S72,,8,0,8,2
12.11,12.11,,0,0,0,0
11.190,11.190,,0,0,0,0
12.110B,12.110B,,5,0,5,0
12.511,12.511,,0,0,0,0
12.110A,12.110A,,4,0,4,0
12.113,12.113,,4,1,5,0
24.03,24.03,,0,0,0,0
12.115,12.115,,4,0,4,0
21M.842,21M.842,,0,0,0,0
11.191,11.191,,0,0,0,0
12.116,12.116,,4,0,4,0
9.35,9.35,,10,1,11,3
12.117B,12.117B,,5,0,5,0
12.117A,12.117A,,5,0,5,0
12.119,12.119,,0,0,0,0
11.192,11.192,,0,0,0,0
12.120,12.120,,8,0,8,2
12.141,12.141,,0,0,0,0
15.S75,15.S75,,8,0,8,2
12.158,12.158,,8,0,8,2
24.901,24.901,,5,3,8,0
12.170,12.170,,10,0,10,4
21M.846,21M.846,,0,0,0,0
12.174,12.174,,8,0,8,1
11.193,11.193,,0,0,0,0
15.THG,15.THG,,8,0,8,2
12.177,12.177,,14,0,14,1
11.194,11.194,,0,0,0,0
22.16,22.16,,12,0,12,0
SP.35UR,SP.35UR,,0,0,0,0
15.UR,15.UR,,0,0,0,0
17.267,17.267,,0,0,0,0
11.201,11.201,,0,0,0,0
SDM.THG,SDM.THG,,8,0,8,2
21M.851,21M.851,,8,0,8,2
11.202,11.202,,5,1,6,0
SP.3S50,SP.3S50,,8,0,8,2
21M.848,21M.848,,2,0,2,3
11.203,11.203,,0,2,2,3
24.902,24.902,,5,3,8,0
16.00,16.00,,0,0,0,0
SP.360,SP.360,,0,0,0,0
12.201,12.201,,2,0,2,4
12.213,12.213,,0,0,0,0
12.820,12.820,,6,0,6,0
MAS.S73,MAS.S73,,0,0,0,0
12.301,12.301,,17,0,17,1
6.01,6.01,,12,4,16,4
MAS.S74,MAS.S74,,0,0,0,0
11.220,11.220,,8,2,10,3
17.269,17.269,,0,0,0,0
12.318,12.318,,6,0,6,0
MAS.S75,MAS.S75,,8,0,8,2
15.828,15.828,,0,0,0,0
12.335,12.335,,8,1,9,1
11.225,11.225,,0,0,0,0
MAS.110,MAS.110,,0,0,0,0
MAS.111,MAS.111,,0,0,0,0
MAS.131,MAS.131,,8,0,8,2
15.389,15.389,,0,0,0,0
11.312,11.312,,0,0,0,0
18.726,18.726,,6,0,6,0
MAS.THG,MAS.THG,,8,0,8,2
12.S680,12.S680,,8,0,8,2
IDS.062,IDS.062,,8,0,8,2
2.500,2.500,,16,0,16,0
17.UR,17.UR,,0,0,0,0
CMS.842,CMS.842,,0,0,0,0
17.275,17.275,,0,0,0,0
15.833,15.833,,0,0,0,0
11.523,11.523,,8,0,8,2
AS.812,AS.812,,8,0,8,2
4.291,4.291,,8,0,8,2
4.299,4.299,,8,0,8,2
21H.UR,21H.UR,,0,0,0,0
24.118,24.118,,0,0,0,0
24.215,24.215,,0,0,0,0
24.241,24.241,,0,0,0,0
7.343,7.343,,6,0,6,0
12.823,12.823,,6,0,6,0
24.242,24.242,,12,0,12,0
24.244,24.244,,4,0,4,0
24.243,24.243,,12,0,12,0
24.245,24.245,,12,0,12,0
24.251,24.251,,0,0,0,0
24.260,24.260,,0,0,0,0
24.292,24.292,,0,0,0,0
17.28,17.28,,0,0,0,0
24.400,24.400,,8,0,8,2
24.293,24.293,,0,0,0,0
24.280,24.280,,0,0,0,0
AS.102,AS.102,,3,2,5,3
24.410,24.410,,8,0,8,2
18.704,18.704,,8,0,8,1
24.500,24.500,,8,0,8,2
24.501,24.501,,8,0,8,2
4.S41,4.S41,,0,0,0,0
24.502,24.502,,8,0,8,2
24.503,24.503,,8,0,8,2
24.601,24.601,,8,0,8,2
15.451,15.451,,5,0,5,0
24.602,24.602,,8,0,8,2
24.904,24.904,,13,0,13,0
18.708,18.708,,6,0,6,0
HST.582,HST.582,,6,0,6,1
18.725,18.725,,6,0,6,0
24.906,24.906,,5,0,5,0
MAS.690,MAS.690,,8,0,8,2
17.276,17.276,,10,0,10,2
12.824,12.824,,13,0,13,0
24.729,24.729,,8,0,8,2
18.715,18.715,,7,0,7,0
4.S45,4.S45,,8,0,8,2
24.892,24.892,,11,0,11,2
5.35U,5.35U,,0,0,0,0
24.908,24.908,,0,0,0,0
EC.740,EC.740,,0,0,0,0
16.003,16.003,,5,7,12,4
2.23,2.23,,2,0,2,4
15.572,15.572,,8,0,8,2
18.737,18.737,,6,0,6,0
4.520,4.520,,0,0,0,0
24.909,24.909,,3,0,3,0
24.912,24.912,,0,0,0,0
24.910,24.910,,11,0,11,0
12.524,12.524,,2,0,2,4
16.06,16.06,,3,1,4,4
24.914,24.914,,5,0,5,0
1.72,1.72,,0,1,1,4
15.3941,15.3941,,0,0,0,0
12.522,12.522,,3,0,3,4
21A.157,21A.157,,0,0,0,0
17.307,17.307,,8,0,8,2
15.840,15.840,,0,0,0,0
4.593,4.593,,8,0,8,2
4.227,4.227,,8,0,8,2
12.843,12.843,,13,0,13,0
21A.301,21A.301,,0,0,0,0
EC.750,EC.750,,0,0,0,0
21A.302,21A.302,,0,0,0,0
24.893,24.893,,8,0,8,2
15.395,15.395,,0,0,0,0
2.110,2.110,,8,0,8,1
21A.303,21A.303,,0,0,0,0
21A.305,21A.305,,0,0,0,0
18.757,18.757,,6,0,6,0
18.782,18.782,,6,0,6,0
6.008,6.008,,14,3,17,1
9.46,9.46,,5,0,5,3
8.231,8.231,,2,0,2,4
24.S96,24.S96,,8,0,8,2
4.612,4.612,,8,0,8,2
24.S94,24.S94,,8,0,8,2
21H.102,21H.102,,0,0,0,0
24.S95,24.S95,,8,0,8,2
15.396,15.396,,0,0,0,0
24.S93,24.S93,,0,0,0,0
6.009,6.009,,4,3,7,1
4.614,4.614,,0,0,0,0
4.619,4.619,,8,1,9,2
STS.027,STS.027,,8,0,8,2
24.S41,24.S41,,8,0,8,2
4.621,4.621,,8,1,9,2
24.S90,24.S90,,13,0,13,0
24.S40,24.S40,,0,0,0,0
4.625,4.625,,8,0,8,2
21A.310,21A.310,,0,0,0,0
4.S50,4.S50,,0,0,0,0
4.633,4.633,,8,0,8,2
4.640,4.640,,8,0,8,2
24.S00,24.S00,,0,0,0,0
24.S20,24.S20,,0,0,0,0
15.579,15.579,,0,0,0,0
24.993,24.993,,8,0,8,2
4.636,4.636,,0,0,0,0
21A.319,21A.319,,8,0,8,2
24.979,24.979,,8,0,8,2
4.641,4.641,,0,0,0,0
24.981,24.981,,14,0,14,0
24.973,24.973,,8,0,8,2
4.645,4.645,,13,0,13,0
14.391,14.391,,2,0,2,3
24.URG,24.URG,,0,0,0,0
4.661,4.661,,8,1,9,2
4.675,4.675,,0,0,0,0
4.647,4.647,,12,0,12,0
AS.811,AS.811,,12,0,12,2
6.011,6.011,,4,4,8,1
4.651,4.651,,0,0,0,0
AS.512,AS.512,,12,0,12,2
21A.300,21A.300,,0,0,0,0
4.657,4.657,,0,0,0,0
AS.511,AS.511,,13,0,13,2
4.671,4.671,,0,0,0,0
EC.780,EC.780,,0,0,0,0
6.012,6.012,,4,2,6,1
12.476,12.476,,8,0,8,2
15.580,15.580,,0,0,0,0
SCM.S91,SCM.S91,,0,0,0,0
6.02,6.02,,4,0,4,0
4.677,4.677,,8,0,8,2
21H.380,21H.380,,0,0,0,0
4.683,4.683,,8,0,8,2
17.310,17.310,,8,0,8,2
4.684,4.684,,8,0,8,2
4.685,4.685,,8,0,8,2
AS.411,AS.411,,3,2,5,3
4.686,4.686,,3,0,3,2
AS.402,AS.402,,3,1,4,3
4.689,4.689,,8,0,8,2
4.687,4.687,,2,0,2,2
AS.401,AS.401,,3,2,5,3
4.691,4.691,,8,0,8,2
16.100,16.100,,2,0,2,4
4.693,4.693,,8,0,8,2
AS.312,AS.312,,3,2,5,3
15.599,15.599,,8,0,8,2
4.S00,4.S00,,8,0,8,2
4.S13,4.S13,,8,0,8,2
4.S12,4.S12,,8,0,8,2
AS.311,AS.311,,3,2,5,3
4.S02,4.S02,,0,0,0,0
4.S10,4.S10,,0,0,0,0
4.S11,4.S11,,0,0,0,0
12.533,12.533,,8,0,8,2
AS.302,AS.302,,3,2,5,3
4.S22,4.S22,,8,0,8,2
4.S23,4.S23,,8,0,8,2
4.S20,4.S20,,0,0,0,0
AS.301,AS.301,,3,2,5,3
4.S21,4.S21,,0,0,0,0
4.S24,4.S24,,8,0,8,2
4.S25,4.S25,,8,0,8,2
4.S27,4.S27,,8,0,8,2
4.S32,4.S32,,8,0,8,2
4.S33,4.S33,,8,0,8,2
AS.211,AS.211,,3,2,5,3
4.S30,4.S30,,0,0,0,0
4.S31,4.S31,,0,0,0,0
4.S34,4.S34,,8,0,8,2
21A.429,21A.429,,8,0,8,2
AS.202,AS.202,,3,2,5,3
21M.269,21M.269,,13,0,13,0
2.785,2.785,,11,0,11,4
21A.461,21A.461,,0,0,0,0
7.THG,7.THG,,8,0,8,2
17.315,17.315,,0,0,0,0
4.S43,4.S43,,8,0,8,2
4.S42,4.S42,,8,0,8,2
AS.201,AS.201,,3,2,5,3
AS.111,AS.111,,5,1,6,0
AS.101,AS.101,,4,1,5,0
4.S55,4.S55,,8,0,8,2
4.S63,4.S63,,8,0,8,2
4.S60,4.S60,,0,0,0,0
MAS.837,MAS.837,,8,0,8,2
4.S65,4.S65,,8,0,8,2
2.79,2.79,,11,0,11,4
MAS.862,MAS.862,,8,0,8,2
4.THU,4.THU,,6,0,6,0
21A.801,21A.801,,0,0,0,0
MAS.700,MAS.700,,8,0,8,2
5.03,5.03,,4,6,10,4
EC.900,EC.900,,0,0,0,0
EC.910,EC.910,,0,0,0,0
EC.980,EC.980,,0,0,0,0
EC.990,EC.990,,0,0,0,0
EC.S00,EC.S00,,0,0,0,0
EC.S01,EC.S01,,0,0,0,0
EC.S02,EC.S02,,0,0,0,0
21A.506,21A.506,,0,0,0,0
EC.S03,EC.S03,,0,0,0,0
EC.S04,EC.S04,,0,0,0,0
EC.S05,EC.S05,,0,0,0,0
EC.S06,EC.S06,,0,0,0,0
EC.S09,EC.S09,,0,0,0,0
11.352,11.352,,0,0,0,0
EC.S10,EC.S10,,0,0,0,0
EC.S12,EC.S12,,0,0,0,0
EC.S13,EC.S13,,0,0,0,0
17.320,17.320,,8,0,8,2
EC.UR,EC.UR,,0,0,0,0
EC.URG,EC.URG,,0,0,0,0
15.429,15.429,,15,0,15,0
EC.050,EC.050,,0,0,0,0
STS.088,STS.088,,0,0,0,0
EC.074,EC.074,,0,0,0,0
16.680,16.680,,0,0,0,0
EC.075,EC.075,,0,0,0,0
11.601,11.601,,0,0,0,0
5.068,5.068,,2,0,2,4
STS.095,STS.095,,8,0,8,2
5.353,5.353,,0,1,1,4
3.S70,3.S70,,8,0,8,2
MAS.914,MAS.914,,8,0,8,2
5.363,5.363,,2,3,5,4
21A.306,21A.306,,0,0,0,0
21W.773,21W.773,,0,0,0,0
5.361,5.361,,0,1,1,4
EC.717,EC.717,,0,0,0,0
5.362,5.362,,0,0,0,0
EC.210,EC.210,,0,0,0,0
7.05,7.05,,16,20,36,4
EC.310,EC.310,,0,0,0,0
5.36U,5.36U,,0,0,0,0
22.51,22.51,,3,0,3,0
5.371,5.371,,2,0,2,4
5.37,5.37,,0,0,0,0
5.372,5.372,,2,0,2,4
EC.700,EC.700,,0,0,0,0
21A.551,21A.551,,14,0,14,0
5.373,5.373,,3,0,3,4
EC.714,EC.714,,0,0,0,0
5.37U,5.37U,,0,0,0,0
5.381,5.381,,2,0,2,4
5.38,5.38,,0,0,0,0
18.300,18.300,,3,0,3,4
21W.785,21W.785,,0,0,0,0
5.382,5.382,,4,0,4,4
9.54,9.54,,4,0,4,0
EC.721,EC.721,,0,0,0,0
5.383,5.383,,3,0,3,4
15.6171,15.6171,,0,0,0,0
5.44,5.44,,16,0,16,0
5.43,5.43,,4,1,5,0
EC.722,EC.722,,0,0,0,0
5.45,5.45,,2,0,2,4
EM.411,EM.411,,8,0,8,2
EM.S22,EM.S22,,8,0,8,2
EM.S21,EM.S21,,8,0,8,2
EM.S20,EM.S20,,8,0,8,2
EM.451,EM.451,,8,0,8,2
21A.308,21A.308,,0,0,0,0
EM.441,EM.441,,8,0,8,2
EM.442,EM.442,,11,0,11,2
4.431,4.431,,8,0,8,2
EM.421,EM.421,,6,0,6,0
MAS.950,MAS.950,,8,0,8,2
STS.096,STS.096,,0,0,0,0
EM.413,EM.413,,6,0,6,0
EM.THG,EM.THG,,8,0,8,2
3.22,3.22,,12,1,13,14
EM.39,EM.39,,13,0,13,0
EM.412,EM.412,,5,0,5,0
MS.401,MS.401,,6,0,6,0
MS.402,MS.402,,6,0,6,0
3.23,3.23,,2,0,2,4
MS.101,MS.101,,6,0,6,0
MS.102,MS.102,,5,0,5,0
MAS.S61,MAS.S61,,8,0,8,2
MS.302,MS.302,,12,0,12,2
MS.202,MS.202,,12,0,12,2
MS.201,MS.201,,12,0,12,2
15.618,15.618,,0,0,0,0
22.75,22.75,,13,0,13,0
4.432,4.432,,8,0,8,2
2.04,2.04,,0,1,1,4
21G.110,21G.110,,14,0,14,0
3.S73,3.S73,,8,0,8,2
12.850,12.850,,0,0,0,0
EC.719,EC.719,,0,0,0,0
22.74,22.74,,13,0,13,0
21W.794,21W.794,,8,0,8,2
6.730,6.730,,2,0,2,4
3.320,3.320,,12,0,12,0
MS.110,MS.110,,0,0,0,0
15.473,15.473,,0,0,0,0
15.444,15.444,,6,0,6,0
17.486,17.486,,8,0,8,2
NS.31,NS.31,,0,0,0,0
16.301,16.301,,0,0,0,0
NS.41,NS.41,,0,0,0,0
NS.33,NS.33,,0,0,0,0
NS.22,NS.22,,0,0,0,0
NS.32,NS.32,,11,0,11,2
NS.11,NS.11,,0,0,0,0
HST.583,HST.583,,3,0,3,1
3.33,3.33,,2,0,2,14
15.471,15.471,,0,0,0,0
NS.21,NS.21,,0,0,0,0
OR.THP,OR.THP,,8,0,8,2
21A.929,21A.929,,0,0,0,0
21A.939,21A.939,,0,0,0,0
21A.949,21A.949,,0,0,0,0
5.72,5.72,,12,0,12,0
21A.950,21A.950,,0,0,0,0
16.32,16.32,,2,0,2,1
21A.S01,21A.S01,,0,0,0,0
21A.S02,21A.S02,,0,0,0,0
1.322,1.322,,4,0,4,0
21A.S10,21A.S10,,0,0,0,0
21A.S11,21A.S11,,0,0,0,0
7.71,7.71,,4,0,4,0
21A.THT,21A.THT,,0,0,0,0
21A.THU,21A.THU,,6,0,6,1
5.80,5.80,,3,0,3,4
21A.UR,21A.UR,,0,0,0,0
18.305,18.305,,8,0,8,0
5.913,5.913,,8,0,8,2
5.83,5.83,,12,0,12,0
21A.URG,21A.URG,,0,0,0,0
5.891,5.891,,0,0,0,0
15.620,15.620,,0,0,0,0
21A.00,21A.00,,0,1,1,1
5.892,5.892,,0,0,0,0
4.251,4.251,,14,0,14,0
5.921,5.921,,8,0,8,2
24.900,24.900,,0,1,1,3
WGS.225,WGS.225,,0,0,0,0
12.860,12.860,,8,0,8,2
5.941,5.941,,4,0,4,0
21A.111,21A.111,,0,0,0,0
STS.310,STS.310,,8,0,8,2
5.THG,5.THG,,8,0,8,2
21A.120,21A.120,,0,0,0,0
6.03,6.03,,2,0,2,4
5.UR,5.UR,,0,0,0,0
5.URG,5.URG,,0,0,0,0
21A.140,21A.140,,0,0,0,0
6.00,6.00,,0,3,3,3
4.S69,4.S69,,8,0,8,2
21A.141,21A.141,,0,0,0,0
21G.039,21G.039,,0,0,0,0
6.0002,6.0002,,12,6,18,4
21A.150,21A.150,,0,0,0,0
21A.155,21A.155,,0,0,0,0
6.004,6.004,,0,4,4,1
21A.156,21A.156,,0,0,0,0
6.031,6.031,,4,8,12,1
21H.991,21H.991,,0,1,1,3
8.033,8.033,,2,4,6,4
4.587,4.587,,12,0,12,0
6.007,6.007,,3,1,4,4
6.035,6.035,,2,0,2,1
6.034,6.034,,4,1,5,0
21W.898,21W.898,,8,0,8,2
3.41,3.41,,2,0,2,14
EC.790,EC.790,,0,0,0,0
14.453,14.453,,2,1,3,3
21W.899,21W.899,,8,0,8,2
8.044,8.044,,2,7,9,4
12.853,12.853,,14,0,14,0
6.037,6.037,,0,0,0,0
21W.S60,21W.S60,,0,0,0,0
18.303,18.303,,6,0,6,0
6.036,6.036,,4,1,5,0
6.041A,6.041A,,8,3,11,1
6.013,6.013,,2,5,7,4
8.05,8.05,,4,8,12,4
6.042,6.042,,8,5,13,1
21W.THG,21W.THG,,8,0,8,2
14.462,14.462,,4,0,4,0
3.44,3.44,,2,0,2,14
15.875,15.875,,6,0,6,0
8.051,8.051,,2,0,2,4
6.041B,6.041B,,6,18,24,1
11.S949,11.S949,,8,0,8,2
12.862,12.862,,5,0,5,0
21A.502,21A.502,,0,0,0,0
4.488,4.488,,8,0,8,2
21A.504,21A.504,,0,0,0,0
8.07,8.07,,2,4,6,4
21A.505,21A.505,,0,0,0,0
8.06,8.06,,4,0,4,0
6.046,6.046,,3,3,6,1
21A.508,21A.508,,0,0,0,0
21W.THU,21W.THU,,6,0,6,1
21A.509,21A.509,,0,0,0,0
6.045,6.045,,5,2,7,1
21A.520,21A.520,,0,0,0,0
21A.550,21A.550,,0,0,0,0
1.364,1.364,,4,0,4,0
21A.400,21A.400,,0,0,0,0
21W.UR,21W.UR,,0,0,0,0
7.87,7.87,,10,0,10,3
21A.809,21A.809,,8,0,8,2
21A.802,21A.802,,8,0,8,2
14.471,14.471,,4,0,4,0
21A.819,21A.819,,8,0,8,2
STS.360,STS.360,,2,0,2,3
21A.859,21A.859,,0,1,1,3
4.463,4.463,,13,0,13,0
21G.S02,21G.S02,,0,0,0,0
EC.718,EC.718,,0,0,0,0
21W.URG,21W.URG,,0,0,0,0
21G.S03,21G.S03,,0,0,0,0
12.385,12.385,,8,0,8,2
6.047,6.047,,11,0,11,1
21W.011,21W.011,,0,0,0,0
18.965,18.965,,7,1,8,0
11.376,11.376,,8,0,8,2
4.481,4.481,,8,0,8,2
STS.340,STS.340,,8,0,8,2
8.09,8.09,,4,0,4,0
18.952,18.952,,3,0,3,1
7.33,7.33,,3,0,3,4
15.418,15.418,,5,0,5,0
21W.012,21W.012,,0,0,0,0
21W.740,21W.740,,0,0,0,0
8.14,8.14,,2,0,2,4
2.016,2.016,,4,3,7,0
21W.013,21W.013,,0,0,0,0
18.966,18.966,,6,0,6,0
21W.014,21W.014,,0,0,0,0
21G.410,21G.410,,6,2,8,0
